Rk,Season,Team,W,G,W,L,W/L%,Opponent Total FG,Opponent Total FGA,Opponent Total 2P,Opponent Total 2PA,Opponent Total 3P,Opponent Total 3PA,Opponent Total FT,Opponent Total FTA,Opponent Total ORB,Opponent Total DRB,Opponent Total TRB,Opponent Total AST,Opponent Total STL,Opponent Total BLK,Opponent Total TOV,Opponent Total PF,Opponent Total PTS,Opponent Shooting Total FG%,Opponent Shooting Total 2P%,Opponent Shooting Total 3P%,Opponent Shooting Total FT%
1,2023-24,Connecticut,37,40,37,3,.925,894,2278,660,1529,234,749,514,709,395,809,1204,400,214,118,422,663,2536,.392,.432,.312,.725
2,2023-24,Purdue,34,39,34,5,.872,1011,2423,730,1530,281,893,386,534,353,788,1141,555,263,96,368,792,2691,.417,.477,.315,.723
3,2023-24,Houston,32,37,32,5,.865,706,1862,481,1115,225,747,495,734,398,853,1251,422,186,102,585,599,2132,.379,.431,.301,.674
4,2023-24,Indiana State,32,39,32,7,.821,1055,2406,773,1587,282,819,462,624,338,907,1245,424,241,130,437,665,2854,.438,.487,.344,.740
5,2023-24,James Madison,32,36,32,4,.889,878,2112,653,1359,225,753,525,721,358,863,1221,385,214,123,516,621,2506,.416,.481,.299,.728
6,2023-24,Grand Canyon,30,35,30,5,.857,822,2039,600,1345,222,694,480,678,397,784,1181,396,214,94,487,708,2346,.403,.446,.320,.708
7,2023-24,McNeese State,30,34,30,4,.882,712,1829,433,950,279,879,413,580,363,758,1121,420,157,108,556,610,2116,.389,.456,.317,.712
8,2023-24,Illinois,29,38,29,9,.763,1044,2418,811,1734,233,684,466,646,381,878,1259,460,218,122,331,707,2787,.432,.468,.341,.721
9,2023-24,Iowa State,29,37,29,8,.784,768,1909,496,1046,272,863,469,664,357,870,1227,451,224,130,636,674,2277,.402,.474,.315,.706
10,2023-24,North Carolina,29,37,29,8,.784,935,2281,673,1464,262,817,476,644,331,919,1250,374,203,141,392,690,2608,.410,.460,.321,.739
11,2023-24,Samford,29,35,29,6,.829,897,2068,619,1246,278,822,535,780,414,841,1255,485,273,135,583,667,2607,.434,.497,.338,.686
12,2023-24,Drake,28,35,28,7,.800,885,2000,628,1225,257,775,436,618,275,872,1147,370,192,93,431,601,2463,.443,.513,.332,.706
13,2023-24,Utah State,28,35,28,7,.800,906,2070,685,1315,221,755,464,634,330,827,1157,456,223,84,417,645,2497,.438,.521,.293,.732
14,2023-24,Vermont,28,35,28,7,.800,805,1982,582,1272,223,710,372,521,289,894,1183,345,180,113,351,529,2205,.406,.458,.314,.714
15,2023-24,Appalachian State,27,34,27,7,.794,865,2225,639,1493,226,732,327,472,393,843,1236,349,234,84,356,556,2283,.389,.428,.309,.693
16,2023-24,Arizona,27,36,27,9,.750,949,2252,668,1399,281,853,415,583,323,852,1175,496,250,132,483,684,2594,.421,.477,.329,.712
17,2023-24,Auburn,27,35,27,8,.771,784,2029,579,1351,205,678,618,842,403,803,1206,335,233,113,449,665,2391,.386,.429,.302,.734
18,2023-24,College of Charleston,27,35,27,8,.771,939,2112,670,1328,269,784,428,608,327,903,1230,407,214,115,403,577,2575,.445,.505,.343,.704
19,2023-24,Duke,27,36,27,9,.750,884,2055,657,1342,227,713,392,578,327,809,1136,450,192,159,407,579,2387,.430,.490,.318,.678
20,2023-24,Gonzaga,27,35,27,8,.771,882,2169,615,1374,267,795,389,541,371,739,1110,434,190,90,392,584,2420,.407,.448,.336,.719
21,2023-24,High Point,27,36,27,9,.750,944,2142,712,1466,232,676,560,771,338,796,1134,421,178,100,360,762,2680,.441,.486,.343,.726
22,2023-24,Marquette,27,37,27,10,.730,919,2156,608,1233,311,923,434,580,397,929,1326,546,211,114,544,540,2583,.426,.493,.337,.748
23,2023-24,Tennessee,27,36,27,9,.750,814,2091,546,1232,268,859,530,746,382,883,1265,398,226,101,469,652,2426,.389,.443,.312,.710
24,2023-24,Colorado,26,37,26,11,.703,984,2234,732,1447,252,787,434,610,330,787,1117,430,272,136,392,657,2654,.440,.506,.320,.711
25,2023-24,Morehead State,26,35,26,9,.743,789,2006,588,1341,201,665,441,587,327,746,1073,331,207,90,367,547,2220,.393,.438,.302,.751
26,2023-24,Nevada,26,34,26,8,.765,789,1886,538,1103,251,783,447,639,317,793,1110,441,169,80,405,716,2276,.418,.488,.321,.700
27,2023-24,New Mexico,26,36,26,10,.722,896,2122,662,1351,234,771,519,710,354,922,1276,486,211,155,504,653,2545,.422,.490,.304,.731
28,2023-24,NC State,26,41,26,15,.634,1043,2408,746,1521,297,887,559,760,424,1060,1484,527,210,130,501,662,2942,.433,.490,.335,.736
29,2023-24,St. Mary's (CA),26,34,26,8,.765,712,1797,545,1265,167,532,422,588,254,688,942,336,182,97,369,539,2013,.396,.431,.314,.718
30,2023-24,San Diego State,26,37,26,11,.703,857,2117,588,1250,269,867,484,681,377,868,1245,426,227,112,460,686,2467,.405,.470,.310,.711
31,2023-24,South Carolina,26,34,26,8,.765,825,1913,622,1314,203,599,444,605,318,793,1111,393,198,157,332,555,2297,.431,.473,.339,.734
32,2023-24,Alabama,25,37,25,12,.676,1028,2351,751,1478,277,873,673,912,446,878,1324,472,273,163,418,739,3006,.437,.508,.317,.738
33,2023-24,Colgate,25,35,25,10,.714,834,2020,585,1208,249,812,325,485,312,844,1156,444,198,86,393,502,2242,.413,.484,.307,.670
34,2023-24,Colorado State,25,36,25,11,.694,865,2030,645,1346,220,684,472,637,333,847,1180,407,195,100,415,604,2422,.426,.479,.322,.741
35,2023-24,Creighton,25,35,25,10,.714,972,2324,763,1676,209,648,293,372,345,831,1176,401,210,99,266,517,2446,.418,.455,.323,.788
36,2023-24,Dayton,25,33,25,8,.758,816,1948,566,1166,250,782,311,427,338,743,1081,417,195,100,342,547,2193,.419,.485,.320,.728
37,2023-24,Duquesne,25,37,25,12,.676,862,2037,618,1269,244,768,499,704,383,885,1268,459,235,140,485,624,2467,.423,.487,.318,.709
38,2023-24,Florida Atlantic,25,34,25,9,.735,912,2096,657,1340,255,756,416,572,370,789,1159,356,204,84,394,611,2495,.435,.490,.337,.727
39,2023-24,Seton Hall,25,37,25,12,.676,926,2193,619,1262,307,931,428,562,382,820,1202,526,273,163,450,603,2587,.422,.490,.330,.762
40,2023-24,South Florida,25,33,25,8,.758,806,1924,576,1194,230,730,446,665,378,835,1213,408,204,98,420,611,2288,.419,.482,.315,.671
41,2023-24,Tarleton State,25,35,25,10,.714,854,1956,619,1245,235,711,459,663,383,836,1219,413,200,126,502,591,2402,.437,.497,.331,.692
42,2023-24,Washington State,25,35,25,10,.714,834,1979,634,1363,200,616,467,639,309,798,1107,380,197,92,365,594,2335,.421,.465,.325,.731
43,2023-24,Akron,24,35,24,11,.686,853,1985,629,1247,224,738,386,561,309,825,1134,391,205,87,404,599,2316,.430,.504,.304,.688
44,2023-24,Baylor,24,35,24,11,.686,904,1987,666,1279,238,708,443,603,308,715,1023,479,244,120,414,665,2489,.455,.521,.336,.735
45,2023-24,UC Irvine,24,34,24,10,.706,817,1984,616,1381,201,603,486,682,343,777,1120,399,194,127,421,605,2321,.412,.446,.333,.713
46,2023-24,Clemson,24,36,24,12,.667,885,2140,594,1261,291,879,502,686,355,871,1226,396,218,90,341,573,2563,.414,.471,.331,.732
47,2023-24,Fairfield,24,37,24,13,.649,987,2156,718,1364,269,792,383,549,375,924,1299,497,210,109,515,566,2626,.458,.526,.340,.698
48,2023-24,Florida,24,36,24,12,.667,1017,2311,773,1563,244,748,573,805,403,886,1289,431,269,145,389,698,2851,.440,.495,.326,.712
49,2023-24,Montana,24,36,24,12,.667,926,2085,701,1412,225,673,509,706,331,842,1173,400,209,107,349,575,2586,.444,.496,.334,.721
50,2023-24,Norfolk State,24,35,24,11,.686,762,1866,477,1024,285,842,555,768,363,795,1158,466,205,104,538,645,2364,.408,.466,.338,.723
51,2023-24,Oakland,24,36,24,12,.667,951,2175,650,1286,301,889,431,586,371,877,1248,595,215,108,403,593,2634,.437,.505,.339,.735
52,2023-24,Oregon,24,36,24,12,.667,928,2059,663,1301,265,758,481,665,330,891,1221,471,191,127,442,631,2602,.451,.510,.350,.723
53,2023-24,Princeton,24,29,24,5,.828,718,1616,513,987,205,629,291,403,223,705,928,349,135,80,321,467,1932,.444,.520,.326,.722
54,2023-24,Quinnipiac,24,34,24,10,.706,874,2074,617,1306,257,768,417,591,338,799,1137,448,230,137,440,532,2422,.421,.472,.335,.706
55,2023-24,VCU,24,38,24,14,.632,870,2138,610,1307,260,831,534,728,366,893,1259,428,270,86,425,639,2534,.407,.467,.313,.734
56,2023-24,UAB,23,35,23,12,.657,943,2122,675,1343,268,779,473,655,397,818,1215,463,247,145,403,654,2627,.444,.503,.344,.722
57,2023-24,Bradley,23,35,23,12,.657,804,1955,559,1206,245,749,495,688,343,813,1156,398,234,72,438,539,2348,.411,.464,.327,.719
58,2023-24,Brigham Young,23,34,23,11,.676,856,2003,638,1322,218,681,448,641,306,830,1136,405,206,80,381,520,2378,.427,.483,.320,.699
59,2023-24,Purdue Fort Wayne,23,36,23,13,.639,930,2080,685,1310,245,770,472,665,351,979,1330,469,201,107,581,588,2577,.447,.523,.318,.710
60,2023-24,Kansas,23,34,23,11,.676,842,2055,553,1206,289,849,403,579,338,809,1147,438,231,94,395,549,2376,.410,.459,.340,.696
61,2023-24,Kentucky,23,33,23,10,.697,917,2138,632,1279,285,859,511,715,398,817,1215,479,211,116,391,562,2630,.429,.494,.332,.715
62,2023-24,Loyola Chicago,23,33,23,10,.697,747,1858,519,1190,228,668,506,687,296,812,1108,370,220,137,414,567,2228,.402,.436,.341,.737
63,2023-24,Nebraska,23,34,23,11,.676,854,2136,566,1251,288,885,415,592,414,854,1268,448,209,125,387,551,2411,.400,.452,.325,.701
64,2023-24,Richmond,23,33,23,10,.697,783,1932,536,1146,247,786,375,514,324,900,1224,375,153,94,381,499,2188,.405,.468,.314,.730
65,2023-24,San Francisco,23,34,23,11,.676,776,1814,545,1122,231,692,479,683,265,765,1030,377,186,69,473,508,2262,.428,.486,.334,.701
66,2023-24,Seattle,23,37,23,14,.622,871,2115,661,1395,210,720,519,741,333,877,1210,412,239,117,457,673,2471,.412,.474,.292,.700
67,2023-24,Texas Tech,23,34,23,11,.676,864,2009,614,1233,250,776,390,546,369,779,1148,407,202,117,389,581,2368,.430,.498,.322,.714
68,2023-24,Virginia,23,34,23,11,.676,732,1805,514,1090,218,715,349,466,316,865,1181,381,170,108,408,444,2033,.406,.472,.305,.749
69,2023-24,Yale,23,33,23,10,.697,788,1873,523,1089,265,784,385,523,273,803,1076,451,182,111,365,531,2226,.421,.480,.338,.736
70,2023-24,Boise State,22,33,22,11,.667,796,1818,588,1147,208,671,421,580,242,742,984,386,190,123,377,576,2221,.438,.513,.310,.726
71,2023-24,Cincinnati,22,37,22,15,.595,900,2148,649,1401,251,747,471,626,328,864,1192,480,247,133,445,580,2522,.419,.463,.336,.752
72,2023-24,Cornell,22,30,22,8,.733,806,1828,553,1068,253,760,376,585,347,722,1069,430,201,89,402,475,2241,.441,.518,.333,.643
73,2023-24,Louisiana Tech,22,32,22,10,.688,716,1832,494,1166,222,666,411,579,336,715,1051,326,222,95,406,589,2065,.391,.424,.333,.710
74,2023-24,UMass Lowell,22,32,22,10,.688,851,2055,650,1354,201,701,358,518,332,732,1064,363,254,118,378,600,2261,.414,.480,.287,.691
75,2023-24,Memphis,22,32,22,10,.688,855,2001,565,1147,290,854,424,593,406,763,1169,456,230,138,443,591,2424,.427,.493,.340,.715
76,2023-24,UNC Asheville,22,34,22,12,.647,884,2054,644,1309,240,745,477,672,387,817,1204,418,210,104,434,677,2485,.430,.492,.322,.710
77,2023-24,Northwestern,22,34,22,12,.647,806,1788,576,1120,230,668,506,702,300,837,1137,477,167,133,422,567,2348,.451,.514,.344,.721
78,2023-24,Ohio State,22,36,22,14,.611,913,2133,664,1416,249,717,453,638,376,859,1235,429,183,98,388,655,2528,.428,.469,.347,.710
79,2023-24,Pittsburgh,22,33,22,11,.667,793,1841,574,1130,219,711,427,562,264,836,1100,408,165,115,366,555,2232,.431,.508,.308,.760
80,2023-24,South Dakota State,22,35,22,13,.629,876,2079,535,1101,341,978,397,534,310,863,1173,434,238,101,395,602,2490,.421,.486,.349,.743
81,2023-24,Stetson,22,35,22,13,.629,957,2168,681,1345,276,823,376,526,390,824,1214,484,208,90,335,581,2566,.441,.506,.335,.715
82,2023-24,Utah,22,37,22,15,.595,1002,2347,715,1492,287,855,417,609,372,972,1344,514,235,118,375,618,2708,.427,.479,.336,.685
83,2023-24,Western Carolina,22,32,22,10,.688,789,1934,588,1322,201,612,419,595,305,802,1107,286,168,88,311,521,2198,.408,.445,.328,.704
84,2023-24,Western Kentucky,22,34,22,12,.647,889,2144,610,1267,279,877,474,687,361,882,1243,444,247,147,480,608,2531,.415,.481,.318,.690
85,2023-24,Wisconsin,22,36,22,14,.611,896,1961,648,1289,248,672,480,663,278,835,1113,424,181,144,406,658,2520,.457,.503,.369,.724
86,2023-24,Youngstown State,22,32,22,10,.688,821,1966,581,1244,240,722,387,555,336,761,1097,450,191,92,383,546,2269,.418,.467,.332,.697
87,2023-24,Little Rock,21,34,21,13,.618,844,2012,595,1240,249,772,527,711,377,788,1165,412,192,101,425,576,2464,.419,.480,.323,.741
88,2023-24,UC San Diego,21,33,21,12,.636,837,1911,606,1218,231,693,385,539,314,811,1125,412,152,117,381,574,2290,.438,.498,.333,.714
89,2023-24,Chattanooga,21,33,21,12,.636,851,2039,559,1179,292,860,368,546,357,775,1132,409,216,89,343,530,2362,.417,.474,.340,.674
90,2023-24,Cleveland State,21,36,21,15,.583,929,2047,695,1263,234,784,530,751,424,897,1321,469,195,111,497,600,2622,.454,.550,.298,.706
91,2023-24,Eastern Washington,21,32,21,11,.656,836,1912,555,1131,281,781,454,612,304,705,1009,435,217,79,384,622,2407,.437,.491,.360,.742
92,2023-24,Grambling State,21,36,21,15,.583,891,2042,649,1339,242,703,482,664,388,815,1203,495,254,105,461,586,2506,.436,.485,.344,.726
93,2023-24,Long Beach State,21,36,21,15,.583,951,2205,616,1238,335,967,498,689,389,900,1289,561,255,98,491,728,2735,.431,.498,.346,.723
94,2023-24,Longwood,21,35,21,14,.600,837,1902,573,1141,264,761,458,667,284,757,1041,416,223,103,477,679,2396,.440,.502,.347,.687
95,2023-24,Merrimack,21,33,21,12,.636,782,1873,596,1281,186,592,409,583,406,846,1252,441,229,103,536,553,2159,.418,.465,.314,.702
96,2023-24,Mississippi State,21,35,21,14,.600,844,2016,597,1186,247,830,482,641,346,794,1140,410,256,132,443,631,2417,.419,.503,.298,.752
97,2023-24,UNLV,21,34,21,13,.618,835,1954,592,1197,243,757,428,567,362,786,1148,489,209,117,420,564,2341,.427,.495,.321,.755
98,2023-24,UNC Greensboro,21,32,21,11,.656,749,1826,483,1023,266,803,469,635,330,753,1083,358,185,85,371,511,2233,.410,.472,.331,.739
99,2023-24,UNC Wilmington,21,31,21,10,.677,792,1762,566,1117,226,645,392,560,321,755,1076,344,124,84,383,559,2202,.449,.507,.350,.700
100,2023-24,Providence,21,35,21,14,.600,872,2094,627,1379,245,715,418,580,360,870,1230,381,236,102,411,607,2407,.416,.455,.343,.721
101,2023-24,Saint Joseph's,21,35,21,14,.600,873,2080,581,1196,292,884,431,598,371,858,1229,478,243,141,427,557,2469,.420,.486,.330,.721
102,2023-24,Sam Houston State,21,33,21,12,.636,794,1862,564,1136,230,726,464,675,317,816,1133,411,231,132,445,592,2282,.426,.496,.317,.687
103,2023-24,UT Martin,21,32,21,11,.656,904,2170,616,1284,288,886,359,499,346,874,1220,454,216,130,340,558,2455,.417,.480,.325,.719
104,2023-24,Texas,21,34,21,13,.618,826,1940,612,1303,214,637,476,660,362,796,1158,392,215,116,438,554,2342,.426,.470,.336,.721
105,2023-24,Texas A&M,21,36,21,15,.583,898,2095,580,1155,318,940,477,668,355,857,1212,534,191,191,409,710,2591,.429,.502,.338,.714
106,2023-24,Texas A&M–Corpus Christi,21,33,21,12,.636,714,1755,519,1108,195,647,577,815,280,829,1109,360,226,135,494,608,2200,.407,.468,.301,.708
107,2023-24,TCU,21,34,21,13,.618,867,1932,643,1254,224,678,481,683,329,774,1103,492,233,132,501,599,2439,.449,.513,.330,.704
108,2023-24,Wake Forest,21,35,21,14,.600,885,2045,645,1320,240,725,463,616,313,827,1140,378,205,121,397,615,2473,.433,.489,.331,.752
109,2023-24,Western Illinois,21,33,21,12,.636,819,2018,633,1392,186,626,343,475,346,775,1121,354,244,107,334,573,2167,.406,.455,.297,.722
110,2023-24,Arkansas State,20,37,20,17,.541,1023,2234,811,1632,212,602,592,778,377,927,1304,414,258,158,369,610,2850,.458,.497,.352,.761
111,2023-24,Belmont,20,33,20,13,.606,914,2067,645,1240,269,827,396,549,337,857,1194,492,222,97,398,541,2493,.442,.520,.325,.721
112,2023-24,Boston College,20,36,20,16,.556,932,2121,655,1320,277,801,446,595,333,902,1235,476,225,123,386,541,2587,.439,.496,.346,.750
113,2023-24,Bowling Green,20,34,20,14,.588,899,2028,645,1328,254,700,362,533,301,881,1182,421,213,125,405,610,2414,.443,.486,.363,.679
114,2023-24,Bryant,20,33,20,13,.606,874,2204,632,1431,242,773,498,714,425,976,1401,405,242,107,416,568,2488,.397,.442,.313,.697
115,2023-24,UC Davis,20,33,20,13,.606,777,1803,585,1202,192,601,500,684,338,777,1115,375,224,93,481,619,2246,.431,.487,.319,.731
116,2023-24,Central Connecticut State,20,31,20,11,.645,764,1809,549,1175,215,634,318,474,302,749,1051,420,209,98,396,488,2061,.422,.467,.339,.671
117,2023-24,Drexel,20,32,20,12,.625,784,1874,575,1212,209,662,353,500,280,719,999,344,175,98,289,515,2130,.418,.474,.316,.706
118,2023-24,George Mason,20,32,20,12,.625,723,1791,462,1039,261,752,402,559,314,695,1009,373,217,115,343,566,2109,.404,.445,.347,.719
119,2023-24,Georgia,20,37,20,17,.541,998,2289,716,1437,282,852,486,671,418,987,1405,541,238,158,423,667,2764,.436,.498,.331,.724
120,2023-24,Hawaii,20,34,20,14,.588,860,1935,706,1439,154,496,463,638,286,800,1086,317,212,82,371,621,2337,.444,.491,.310,.726
121,2023-24,Hofstra,20,33,20,13,.606,786,1899,512,1103,274,796,413,543,343,821,1164,424,183,83,395,466,2259,.414,.464,.344,.761
122,2023-24,Lipscomb,20,32,20,12,.625,926,2015,658,1261,268,754,328,459,324,791,1115,387,164,114,369,493,2448,.460,.522,.355,.715
123,2023-24,Massachusetts,20,31,20,11,.645,739,1755,513,1081,226,674,489,678,333,720,1053,407,193,103,407,567,2193,.421,.475,.335,.721
124,2023-24,Michigan State,20,35,20,15,.571,800,1938,537,1132,263,806,449,628,344,832,1176,438,186,112,432,588,2312,.413,.474,.326,.715
125,2023-24,Milwaukee,20,35,20,15,.571,962,2194,674,1358,288,836,541,724,413,845,1258,540,244,149,404,638,2753,.438,.496,.344,.747
126,2023-24,Ole Miss,20,32,20,12,.625,843,1916,604,1208,239,708,440,619,419,767,1186,467,210,97,398,554,2365,.440,.500,.338,.711
127,2023-24,Nicholls State,20,34,20,14,.588,879,2025,650,1298,229,727,527,779,403,849,1252,435,259,125,389,592,2514,.434,.501,.315,.677
128,2023-24,Ohio,20,33,20,13,.606,809,1904,571,1189,238,715,453,649,375,823,1198,363,165,117,452,560,2309,.425,.480,.333,.698
129,2023-24,Oklahoma,20,32,20,12,.625,782,1855,584,1193,198,662,439,578,290,719,1009,375,232,114,364,572,2201,.422,.490,.299,.760
130,2023-24,Santa Clara,20,33,20,13,.606,843,1984,613,1251,230,733,468,662,314,751,1065,411,231,83,337,585,2384,.425,.490,.314,.707
131,2023-24,SMU,20,33,20,13,.606,793,1921,571,1220,222,701,463,647,378,768,1146,448,239,168,428,501,2271,.413,.468,.317,.716
132,2023-24,St. Bonaventure,20,33,20,13,.606,798,1799,553,1067,245,732,424,610,304,756,1060,463,165,97,426,529,2265,.444,.518,.335,.695
133,2023-24,St. John's (NY),20,33,20,13,.606,824,1904,585,1221,239,683,487,655,350,756,1106,444,209,109,426,522,2374,.433,.479,.350,.744
134,2023-24,St. Thomas,20,33,20,13,.606,777,1738,552,1056,225,682,361,500,257,768,1025,382,161,79,395,532,2140,.447,.523,.330,.722
135,2023-24,Stony Brook,20,35,20,15,.571,908,2148,595,1247,313,901,402,580,384,915,1299,519,210,87,370,542,2531,.423,.477,.347,.693
136,2023-24,Syracuse,20,32,20,12,.625,899,1964,649,1232,250,732,372,511,360,843,1203,456,200,93,463,512,2420,.458,.527,.342,.728
137,2023-24,UT Arlington,20,34,20,14,.588,828,1961,588,1270,240,691,596,805,358,785,1143,455,256,121,465,666,2492,.422,.463,.347,.740
138,2023-24,Toledo,20,32,20,12,.625,916,1909,674,1199,242,710,362,500,307,769,1076,434,191,137,418,577,2436,.480,.562,.341,.724
139,2023-24,Towson,20,34,20,14,.588,770,1833,548,1157,222,676,402,578,311,739,1050,365,214,114,375,539,2164,.420,.474,.328,.696
140,2023-24,Troy,20,32,20,12,.625,777,1815,564,1206,213,609,494,707,338,759,1097,345,259,129,496,587,2261,.428,.468,.350,.699
141,2023-24,Weber State,20,32,20,12,.625,799,1743,579,1107,220,636,343,485,235,794,1029,409,163,87,405,562,2161,.458,.523,.346,.707
142,2023-24,Austin Peay,19,35,19,16,.543,910,1967,680,1254,230,713,511,721,360,881,1241,423,151,119,400,557,2561,.463,.542,.323,.709
143,2023-24,Cal State Northridge,19,34,19,15,.559,825,2037,531,1129,294,908,559,764,343,844,1187,484,271,117,455,655,2503,.405,.470,.324,.732
144,2023-24,Charlotte,19,31,19,12,.613,731,1714,533,1086,198,628,374,529,305,715,1020,337,178,83,311,505,2034,.426,.491,.315,.707
145,2023-24,Delaware,19,33,19,14,.576,848,1991,624,1268,224,723,379,536,338,798,1136,390,210,125,334,513,2299,.426,.492,.310,.707
146,2023-24,East Tennessee State,19,35,19,16,.543,849,1961,604,1212,245,749,492,713,356,898,1254,402,238,115,468,594,2435,.433,.498,.327,.690
147,2023-24,Indiana,19,33,19,14,.576,845,2013,561,1184,284,829,478,637,363,793,1156,447,247,101,341,611,2452,.420,.474,.343,.750
148,2023-24,Iowa,19,34,19,15,.559,969,2114,697,1354,272,760,490,696,381,881,1262,523,202,127,408,591,2700,.458,.515,.358,.704
149,2023-24,Kansas State,19,34,19,15,.559,849,2068,612,1309,237,759,482,684,394,788,1182,450,283,121,382,625,2417,.411,.468,.312,.705
150,2023-24,Lamar,19,33,19,14,.576,808,1919,551,1152,257,767,533,756,377,784,1161,473,240,101,463,613,2406,.421,.478,.335,.705
151,2023-24,Louisiana,19,33,19,14,.576,834,1856,671,1266,163,590,534,741,363,807,1170,366,229,127,487,520,2365,.449,.530,.276,.721
152,2023-24,Minnesota,19,34,19,15,.559,898,1999,679,1390,219,609,429,592,342,774,1116,514,243,107,371,564,2444,.449,.488,.360,.725
153,2023-24,North Texas,19,34,19,15,.559,740,1785,528,1144,212,641,477,667,356,755,1111,339,227,135,419,516,2169,.415,.462,.331,.715
154,2023-24,Northern Colorado,19,33,19,14,.576,912,2028,627,1217,285,811,433,579,295,838,1133,426,223,99,374,537,2542,.450,.515,.351,.748
155,2023-24,Northern Iowa,19,33,19,14,.576,826,1856,560,1086,266,770,428,557,246,846,1092,375,198,97,375,584,2346,.445,.516,.345,.768
156,2023-24,Saint Peter's,19,33,19,14,.576,707,1696,514,1106,193,590,506,723,327,779,1106,366,215,132,449,613,2113,.417,.465,.327,.700
157,2023-24,Southern Illinois,19,32,19,13,.594,789,1747,626,1210,163,537,442,624,266,757,1023,350,187,115,346,563,2183,.452,.517,.304,.708
158,2023-24,Virginia Tech,19,34,19,15,.559,879,1943,656,1285,223,658,432,587,297,788,1085,433,218,103,391,573,2413,.452,.511,.339,.736
159,2023-24,Butler,18,33,18,15,.545,921,2094,670,1317,251,777,339,459,350,837,1187,448,240,136,380,504,2432,.440,.509,.323,.739
160,2023-24,Central Michigan,18,32,18,14,.563,784,1916,540,1136,244,780,430,582,366,840,1206,416,186,108,359,495,2242,.409,.475,.313,.739
161,2023-24,Green Bay,18,32,18,14,.563,782,1799,592,1163,190,636,453,620,305,740,1045,399,201,126,297,500,2207,.435,.509,.299,.731
162,2023-24,Howard,18,35,18,17,.514,913,2035,686,1367,227,668,547,786,373,752,1125,431,266,125,428,663,2600,.449,.502,.340,.696
163,2023-24,Liberty,18,32,18,14,.563,775,1769,596,1198,179,571,367,506,252,790,1042,312,187,114,372,505,2096,.438,.497,.313,.725
164,2023-24,Marist,18,31,18,13,.581,670,1633,471,1007,199,626,389,572,284,745,1029,294,209,79,417,477,1928,.410,.468,.318,.680
165,2023-24,Monmouth,18,33,18,15,.545,819,1919,537,1090,282,829,476,639,381,838,1219,460,185,126,400,520,2396,.427,.493,.340,.745
166,2023-24,North Carolina Central,18,31,18,13,.581,747,1773,566,1129,181,644,464,638,360,736,1096,381,179,106,432,564,2139,.421,.501,.281,.727
167,2023-24,North Dakota,18,32,18,14,.563,849,1871,635,1235,214,636,388,524,277,800,1077,339,187,61,343,550,2300,.454,.514,.336,.740
168,2023-24,Northern Kentucky,18,33,18,15,.545,875,1968,621,1153,254,815,412,566,373,814,1187,485,213,115,480,591,2416,.445,.539,.312,.728
169,2023-24,San Diego,18,33,18,15,.545,885,1941,624,1165,261,776,519,739,365,872,1237,551,247,116,439,551,2550,.456,.536,.336,.702
170,2023-24,Southern,18,32,18,14,.563,729,1676,536,1070,193,606,547,764,291,773,1064,402,215,98,528,556,2198,.435,.501,.318,.716
171,2023-24,Stephen F. Austin,18,33,18,15,.545,759,1792,512,1127,247,665,588,816,336,749,1085,413,260,122,563,690,2353,.424,.454,.371,.721
172,2023-24,Tennessee State,18,33,18,15,.545,790,1873,582,1241,208,632,555,767,372,801,1173,379,228,126,443,582,2343,.422,.469,.329,.724
173,2023-24,UTEP,18,34,18,16,.529,798,1768,604,1160,194,608,558,792,336,834,1170,374,255,123,636,660,2348,.451,.521,.319,.705
174,2023-24,Villanova,18,34,18,16,.529,788,1926,502,1054,286,872,369,501,287,870,1157,451,188,135,361,484,2231,.409,.476,.328,.737
175,2023-24,Wright State,18,32,18,14,.563,953,2011,679,1251,274,760,419,587,318,723,1041,429,235,85,390,574,2599,.474,.543,.361,.714
176,2023-24,Bethune-Cookman,17,34,17,17,.500,806,1869,581,1200,225,669,630,886,377,836,1213,470,284,101,562,606,2467,.431,.484,.336,.711
177,2023-24,UCF,17,33,17,16,.515,741,1800,499,1088,242,712,518,711,308,832,1140,427,224,113,469,597,2242,.412,.459,.340,.729
178,2023-24,Denver,17,34,17,17,.500,993,2133,728,1384,265,749,486,657,348,904,1252,439,170,132,362,633,2737,.466,.526,.354,.740
179,2023-24,Eastern Kentucky,17,31,17,14,.548,847,1984,594,1307,253,677,424,572,371,764,1135,411,222,80,350,518,2371,.427,.454,.374,.741
180,2023-24,Evansville,17,35,17,18,.486,912,2074,597,1175,315,899,423,574,318,928,1246,496,226,103,425,557,2562,.440,.508,.350,.737
181,2023-24,Florida State,17,33,17,16,.515,859,1892,603,1169,256,723,544,775,372,842,1214,416,186,98,493,616,2518,.454,.516,.354,.702
182,2023-24,Furman,17,33,17,16,.515,940,2036,697,1327,243,709,383,562,315,868,1183,465,230,118,397,554,2506,.462,.525,.343,.681
183,2023-24,Gardner-Webb,17,33,17,16,.515,839,1934,617,1265,222,669,514,726,311,890,1201,390,196,117,378,580,2414,.434,.488,.332,.708
184,2023-24,Kent State,17,34,17,17,.500,850,1901,603,1144,247,757,477,656,323,809,1132,430,216,105,450,590,2424,.447,.527,.326,.727
185,2023-24,Louisiana State,17,33,17,16,.515,848,1981,573,1160,275,821,503,667,380,778,1158,413,271,133,426,567,2474,.428,.494,.335,.754
186,2023-24,Missouri State,17,33,17,16,.515,859,2067,594,1265,265,802,369,515,313,818,1131,428,215,107,301,548,2352,.416,.470,.330,.717
187,2023-24,Montana State,17,35,17,18,.486,933,2000,705,1319,228,681,512,717,329,904,1233,431,207,87,474,600,2606,.467,.534,.335,.714
188,2023-24,Portland State,17,32,17,15,.531,818,1841,571,1140,247,701,416,604,314,868,1182,448,184,119,419,555,2299,.444,.501,.352,.689
189,2023-24,SIU Edwardsville,17,33,17,16,.515,798,1829,549,1139,249,690,469,655,321,829,1150,421,187,121,407,548,2314,.436,.482,.361,.716
190,2023-24,Texas State,17,35,17,18,.486,853,1954,633,1267,220,687,526,724,354,828,1182,406,266,134,453,621,2452,.437,.500,.320,.727
191,2023-24,Wagner,17,33,17,16,.515,753,1786,535,1059,218,727,359,525,300,862,1162,444,158,106,367,462,2083,.422,.505,.300,.684
192,2023-24,Washington,17,32,17,15,.531,886,2003,651,1305,235,698,461,663,346,811,1157,455,206,111,371,590,2468,.442,.499,.337,.695
193,2023-24,Winthrop,17,32,17,15,.531,785,1864,534,1070,251,794,466,618,356,732,1088,384,218,125,426,702,2287,.421,.499,.316,.754
194,2023-24,Wofford,17,32,17,15,.531,812,1875,532,1075,280,800,458,615,278,779,1057,407,209,88,305,527,2362,.433,.495,.350,.745
195,2023-24,Abilene Christian,16,34,16,18,.471,888,1923,689,1310,199,613,525,766,342,909,1251,420,227,113,495,642,2500,.462,.526,.325,.685
196,2023-24,American,16,32,16,16,.500,776,1706,504,973,272,733,352,508,255,724,979,403,160,78,345,515,2176,.455,.518,.371,.693
197,2023-24,Arkansas,16,33,16,17,.485,909,2039,673,1343,236,696,579,796,366,834,1200,428,213,96,365,685,2633,.446,.501,.339,.727
198,2023-24,Boston University,16,33,16,17,.485,758,1777,511,1059,247,718,433,630,253,846,1099,381,215,97,376,520,2198,.427,.483,.344,.687
199,2023-24,California Baptist,16,33,16,17,.485,816,1855,645,1348,171,507,394,547,266,808,1074,376,194,116,336,606,2197,.440,.478,.337,.720
200,2023-24,UC Riverside,16,34,16,18,.471,877,1901,652,1269,225,632,469,652,279,930,1209,458,154,122,377,581,2448,.461,.514,.356,.719
201,2023-24,UC Santa Barbara,16,31,16,15,.516,848,1871,640,1235,208,636,376,554,292,701,993,382,214,81,310,564,2280,.453,.518,.327,.679
202,2023-24,Iona,16,33,16,17,.485,804,1746,567,1048,237,698,484,655,317,872,1189,454,183,127,502,497,2329,.460,.541,.340,.739
203,2023-24,Jacksonville,16,33,16,17,.485,811,1853,556,1115,255,738,512,723,335,724,1059,411,235,112,417,583,2389,.438,.499,.346,.708
204,2023-24,La Salle,16,33,16,17,.485,866,1942,643,1309,223,633,456,636,351,884,1235,443,165,118,357,504,2411,.446,.491,.352,.717
205,2023-24,Maryland,16,33,16,17,.485,763,1825,583,1276,180,549,468,611,328,819,1147,366,193,119,416,626,2174,.418,.457,.328,.766
206,2023-24,Mercer,16,33,16,17,.485,814,1827,591,1165,223,662,520,719,344,811,1155,366,210,100,403,501,2371,.446,.507,.337,.723
207,2023-24,Kansas City,16,32,16,16,.500,746,1705,542,1068,204,637,521,734,276,758,1034,370,189,83,405,554,2217,.438,.507,.320,.710
208,2023-24,New Hampshire,16,31,16,15,.516,843,1930,620,1182,223,748,388,531,289,916,1205,426,234,142,380,507,2297,.437,.525,.298,.731
209,2023-24,Niagara,16,32,16,16,.500,862,1834,683,1326,179,508,404,567,264,744,1008,357,212,105,363,577,2307,.470,.515,.352,.713
210,2023-24,North Florida,16,32,16,16,.500,889,1928,689,1347,200,581,449,614,313,831,1144,394,221,91,336,485,2427,.461,.512,.344,.731
211,2023-24,Penn State,16,33,16,17,.485,854,1888,666,1268,188,620,526,686,355,863,1218,484,193,104,484,582,2422,.452,.525,.303,.767
212,2023-24,Radford,16,33,16,17,.485,845,1946,598,1165,247,781,424,602,401,757,1158,394,160,86,346,501,2361,.434,.513,.316,.704
213,2023-24,Sacred Heart,16,32,16,16,.500,821,1888,549,1117,272,771,399,591,382,805,1187,476,204,109,464,501,2313,.435,.491,.353,.675
214,2023-24,South Alabama,16,32,16,16,.500,874,1948,654,1254,220,694,453,655,369,869,1238,385,223,133,388,514,2421,.449,.522,.317,.692
215,2023-24,Southern Mississippi,16,32,16,16,.500,814,1889,588,1226,226,663,419,614,349,823,1172,386,260,87,392,554,2273,.431,.480,.341,.682
216,2023-24,Temple,16,36,16,20,.444,912,2085,653,1278,259,807,541,745,374,1026,1400,496,213,134,430,589,2624,.437,.511,.321,.726
217,2023-24,Texas Southern,16,33,16,17,.485,799,1882,578,1198,221,684,527,742,359,843,1202,424,218,113,418,535,2346,.425,.482,.323,.710
218,2023-24,Tulsa,16,31,16,15,.516,800,1872,567,1151,233,721,457,659,357,818,1175,419,219,74,402,578,2290,.427,.493,.323,.693
219,2023-24,UCLA,16,33,16,17,.485,741,1747,492,999,249,748,429,616,299,775,1074,372,182,86,388,607,2160,.424,.492,.333,.696
220,2023-24,Utah Valley,16,32,16,16,.500,774,1834,572,1205,202,629,445,641,308,840,1148,448,225,118,409,577,2195,.422,.475,.321,.694
221,2023-24,Xavier,16,34,16,18,.471,921,2111,671,1364,250,747,446,626,365,858,1223,549,213,164,389,600,2538,.436,.492,.335,.712
222,2023-24,Ball State,15,31,15,16,.484,811,1821,591,1178,220,643,358,505,298,746,1044,383,196,95,369,591,2200,.445,.502,.342,.709
223,2023-24,Binghamton,15,30,15,15,.500,754,1790,521,1099,233,691,426,585,275,724,999,327,203,132,281,513,2167,.421,.474,.337,.728
224,2023-24,Davidson,15,32,15,17,.469,761,1798,509,1042,252,756,400,580,309,819,1128,405,200,105,375,554,2174,.423,.488,.333,.690
225,2023-24,Delaware State,15,34,15,19,.441,831,1914,554,1150,277,764,476,662,338,760,1098,440,248,95,531,634,2415,.434,.482,.363,.719
226,2023-24,East Carolina,15,33,15,18,.455,810,1835,552,1047,258,788,441,587,339,802,1141,431,201,113,415,545,2319,.441,.527,.327,.751
227,2023-24,FDU,15,32,15,17,.469,885,1967,608,1187,277,780,435,626,361,914,1275,483,233,106,464,581,2482,.450,.512,.355,.695
228,2023-24,George Washington,15,32,15,17,.469,917,2128,635,1318,282,810,356,473,364,839,1203,451,218,114,323,515,2472,.431,.482,.348,.753
229,2023-24,Illinois State,15,32,15,17,.469,790,1786,561,1084,229,702,356,484,273,791,1064,407,168,101,345,578,2165,.442,.518,.326,.736
230,2023-24,Jackson State,15,32,15,17,.469,849,1862,589,1124,260,738,460,642,350,779,1129,466,234,122,427,559,2418,.456,.524,.352,.717
231,2023-24,Kennesaw State,15,31,15,16,.484,841,1916,582,1174,259,742,563,782,345,856,1201,401,217,138,418,601,2504,.439,.496,.349,.720
232,2023-24,Le Moyne,15,32,15,17,.469,811,1916,538,1087,273,829,350,492,355,870,1225,459,200,76,424,444,2245,.423,.495,.329,.711
233,2023-24,Maine,15,32,15,17,.469,789,1794,602,1205,187,589,394,575,296,837,1133,411,202,112,422,487,2159,.440,.500,.317,.685
234,2023-24,Miami (FL),15,32,15,17,.469,866,1998,560,1078,306,920,318,446,341,803,1144,497,230,110,373,479,2356,.433,.519,.333,.713
235,2023-24,Miami (OH),15,32,15,17,.469,800,1870,587,1187,213,683,428,589,339,829,1168,378,206,107,399,559,2241,.428,.495,.312,.727
236,2023-24,Omaha,15,33,15,18,.455,839,1871,553,1065,286,806,440,593,271,844,1115,409,177,77,373,604,2404,.448,.519,.355,.742
237,2023-24,North Alabama,15,32,15,17,.469,833,1870,606,1221,227,649,542,750,310,825,1135,396,166,112,325,560,2435,.445,.496,.350,.723
238,2023-24,North Dakota State,15,32,15,17,.469,879,1909,647,1262,232,647,376,517,256,770,1026,369,171,115,303,510,2366,.460,.513,.359,.727
239,2023-24,Rider,15,32,15,17,.469,794,1878,549,1155,245,723,475,679,338,774,1112,412,243,109,368,536,2308,.423,.475,.339,.700
240,2023-24,Rutgers,15,32,15,17,.469,733,1798,501,1089,232,709,431,616,363,904,1267,402,210,133,477,545,2129,.408,.460,.327,.700
241,2023-24,Southeastern Louisiana,15,32,15,17,.469,800,1848,535,1025,265,823,406,557,337,737,1074,484,227,98,382,528,2271,.433,.522,.322,.729
242,2023-24,Southern California,15,33,15,18,.455,855,1981,575,1213,280,768,462,626,377,812,1189,509,227,115,438,569,2452,.432,.474,.365,.738
243,2023-24,Wichita State,15,34,15,19,.441,895,2126,631,1317,264,809,430,590,372,835,1207,471,271,133,348,494,2484,.421,.479,.326,.729
244,2023-24,Wyoming,15,32,15,17,.469,868,1914,606,1147,262,767,385,519,322,747,1069,421,261,123,360,622,2383,.454,.528,.342,.742
245,2023-24,Alcorn State,14,32,14,18,.438,841,1818,530,990,311,828,484,666,316,712,1028,500,203,129,378,572,2477,.463,.535,.376,.727
246,2023-24,Arizona State,14,32,14,18,.438,850,1887,599,1147,251,740,417,589,338,960,1298,490,186,85,439,535,2368,.450,.522,.339,.708
247,2023-24,Bucknell,14,33,14,19,.424,781,1831,531,1059,250,772,405,577,320,792,1112,470,210,104,353,534,2217,.427,.501,.324,.702
248,2023-24,Cal State Fullerton,14,32,14,18,.438,773,1790,555,1103,218,687,448,625,321,816,1137,394,199,85,402,591,2212,.432,.503,.317,.717
249,2023-24,Campbell,14,32,14,18,.438,849,1928,574,1103,275,825,334,467,349,763,1112,439,210,104,379,533,2307,.440,.520,.333,.715
250,2023-24,Canisius,14,32,14,18,.438,864,1913,660,1312,204,601,375,530,321,762,1083,441,217,91,361,492,2307,.452,.503,.339,.708
251,2023-24,Eastern Illinois,14,32,14,18,.438,757,1721,533,1084,224,637,434,605,279,856,1135,424,169,138,454,464,2172,.440,.492,.352,.717
252,2023-24,Florida Gulf Coast,14,32,14,18,.438,819,1845,539,1053,280,792,358,512,307,736,1043,425,202,81,332,485,2276,.444,.512,.354,.699
253,2023-24,Georgia State,14,31,14,17,.452,816,1914,596,1181,220,733,467,657,349,844,1193,404,174,126,326,495,2319,.426,.505,.300,.711
254,2023-24,Georgia Tech,14,32,14,18,.438,846,1976,592,1197,254,779,461,624,339,794,1133,431,221,103,283,520,2407,.428,.495,.326,.739
255,2023-24,Harvard,14,27,14,13,.519,710,1667,479,983,231,684,286,413,313,683,996,375,183,101,298,453,1937,.426,.487,.338,.692
256,2023-24,Idaho State,14,34,14,20,.412,881,1835,682,1267,199,568,422,566,259,770,1029,411,213,80,415,605,2383,.480,.538,.350,.746
257,2023-24,Jacksonville State,14,32,14,18,.438,752,1735,543,1116,209,619,413,588,262,721,983,348,226,99,401,564,2126,.433,.487,.338,.702
258,2023-24,Lehigh,14,32,14,18,.438,828,1880,588,1185,240,695,376,541,262,888,1150,388,209,115,410,545,2272,.440,.496,.345,.695
259,2023-24,Middle Tennessee,14,33,14,19,.424,854,1945,660,1356,194,589,417,574,354,840,1194,367,216,112,367,566,2319,.439,.487,.329,.726
260,2023-24,Northern Arizona,14,33,14,19,.424,905,1908,697,1259,208,649,511,714,343,864,1207,425,244,95,384,560,2529,.474,.554,.320,.716
261,2023-24,Presbyterian,14,33,14,19,.424,825,1801,604,1169,221,632,542,749,298,817,1115,381,195,116,426,611,2413,.458,.517,.350,.724
262,2023-24,Queens (NC),14,33,14,19,.424,985,2096,716,1306,269,790,454,617,342,900,1242,411,212,152,384,594,2693,.470,.548,.341,.736
263,2023-24,South Carolina State,14,32,14,18,.438,778,1719,559,1075,219,644,615,827,318,757,1075,443,262,120,487,590,2390,.453,.520,.340,.744
264,2023-24,Stanford,14,32,14,18,.438,913,2020,642,1261,271,759,350,511,319,821,1140,420,222,88,358,529,2447,.452,.509,.357,.685
265,2023-24,Tulane,14,31,14,17,.452,869,1999,577,1161,292,838,451,633,388,834,1222,500,210,114,401,608,2481,.435,.497,.348,.712
266,2023-24,Alabama State,13,32,13,19,.406,721,1751,476,1025,245,726,534,736,317,943,1260,385,196,152,468,514,2221,.412,.464,.337,.726
267,2023-24,Albany (NY),13,32,13,19,.406,907,1944,740,1368,167,576,540,744,323,829,1152,420,235,149,415,499,2521,.467,.541,.290,.726
268,2023-24,Arkansas–Pine Bluff,13,31,13,18,.419,915,2011,681,1243,234,768,472,657,374,814,1188,510,222,104,362,561,2536,.455,.548,.305,.718
269,2023-24,Brown,13,31,13,18,.419,801,1797,575,1110,226,687,399,573,290,783,1073,411,210,100,369,549,2227,.446,.518,.329,.696
270,2023-24,Cal State Bakersfield,13,32,13,19,.406,722,1675,514,1063,208,612,562,777,325,745,1070,371,184,105,422,550,2214,.431,.484,.340,.723
271,2023-24,California,13,32,13,19,.406,873,1949,621,1243,252,706,467,646,308,856,1164,410,189,114,336,517,2465,.448,.500,.357,.723
272,2023-24,Chicago State,13,32,13,19,.406,827,1789,627,1171,200,618,404,601,362,748,1110,410,224,93,462,546,2258,.462,.535,.324,.672
273,2023-24,Columbia,13,27,13,14,.481,709,1616,483,921,226,695,312,434,269,633,902,404,170,108,336,419,1956,.439,.524,.325,.719
274,2023-24,Eastern Michigan,13,31,13,18,.419,820,1819,595,1107,225,712,387,561,333,796,1129,414,209,98,331,462,2252,.451,.537,.316,.690
275,2023-24,Elon,13,32,13,19,.406,880,1925,614,1142,266,783,387,542,360,766,1126,482,195,101,355,520,2413,.457,.538,.340,.714
276,2023-24,Fordham,13,33,13,20,.394,805,1795,606,1238,199,557,580,809,300,889,1189,404,225,127,459,608,2389,.448,.489,.357,.717
277,2023-24,Marshall,13,33,13,20,.394,922,2060,664,1342,258,718,429,608,349,941,1290,444,247,87,391,534,2531,.448,.495,.359,.706
278,2023-24,Mount St. Mary's,13,32,13,19,.406,819,1890,592,1233,227,657,433,572,315,722,1037,406,285,92,403,478,2298,.433,.480,.346,.757
279,2023-24,Navy,13,31,13,18,.419,715,1660,494,977,221,683,416,582,309,807,1116,397,147,148,420,568,2067,.431,.506,.324,.715
280,2023-24,New Mexico State,13,32,13,19,.406,762,1812,501,1046,261,766,533,759,312,816,1128,428,228,85,373,525,2318,.421,.479,.341,.702
281,2023-24,Notre Dame,13,33,13,20,.394,806,1910,578,1208,228,702,376,524,313,816,1129,406,212,120,328,484,2216,.422,.478,.325,.718
282,2023-24,Oregon State,13,32,13,19,.406,816,1832,585,1133,231,699,463,651,341,751,1092,453,204,96,371,597,2326,.445,.516,.330,.711
283,2023-24,Pepperdine,13,33,13,20,.394,889,1850,670,1273,219,577,446,617,265,815,1080,442,200,77,381,597,2443,.481,.526,.380,.723
284,2023-24,Saint Louis,13,33,13,20,.394,906,1965,603,1135,303,830,505,697,332,823,1155,455,218,130,335,582,2620,.461,.531,.365,.725
285,2023-24,Texas A&M–Commerce,13,33,13,20,.394,871,1906,670,1325,201,581,519,731,361,920,1281,434,187,115,447,492,2462,.457,.506,.346,.710
286,2023-24,Alabama A&M,12,35,12,23,.343,856,2010,595,1268,261,742,680,908,415,843,1258,463,331,114,492,701,2653,.426,.469,.352,.749
287,2023-24,Fresno State,12,33,12,21,.364,901,1952,632,1230,269,722,368,537,344,810,1154,450,201,127,347,526,2439,.462,.514,.373,.685
288,2023-24,Illinois–Chicago,12,33,12,21,.364,818,1920,606,1252,212,668,513,683,330,886,1216,427,219,119,402,478,2361,.426,.484,.317,.751
289,2023-24,Loyola Marymount,12,31,12,19,.387,814,1817,617,1239,197,578,389,533,282,727,1009,417,179,110,264,483,2214,.448,.498,.341,.730
290,2023-24,Murray State,12,32,12,20,.375,811,1750,538,1007,273,743,342,474,253,810,1063,433,155,105,379,490,2237,.463,.534,.367,.722
291,2023-24,Northeastern,12,32,12,20,.375,834,1792,573,1096,261,696,386,507,282,699,981,425,208,96,357,488,2315,.465,.523,.375,.761
292,2023-24,Oklahoma State,12,32,12,20,.375,865,1891,653,1268,212,623,385,522,312,775,1087,396,257,99,369,530,2327,.457,.515,.340,.738
293,2023-24,Oral Roberts,12,31,12,19,.387,831,1882,573,1160,258,722,414,566,344,844,1188,404,153,79,334,428,2334,.442,.494,.357,.731
294,2023-24,Portland,12,33,12,21,.364,970,2089,616,1156,354,933,328,461,323,870,1193,558,205,87,301,581,2622,.464,.533,.379,.711
295,2023-24,Rhode Island,12,32,12,20,.375,890,1967,613,1191,277,776,386,581,326,774,1100,474,224,149,289,590,2443,.452,.515,.357,.664
296,2023-24,South Dakota,12,32,12,20,.375,930,2063,644,1267,286,796,389,536,330,772,1102,435,212,108,281,547,2535,.451,.508,.359,.726
297,2023-24,Western Michigan,12,32,12,20,.375,857,1930,606,1194,251,736,431,597,342,786,1128,440,221,72,352,564,2396,.444,.508,.341,.722
298,2023-24,The Citadel,11,32,11,21,.344,860,1878,597,1129,263,749,306,420,281,753,1034,467,210,125,354,546,2289,.458,.529,.351,.729
299,2023-24,Utah Tech,11,31,11,20,.355,802,1819,575,1149,227,670,558,769,351,775,1126,420,272,112,416,607,2389,.441,.500,.339,.726
300,2023-24,Florida International,11,33,11,22,.333,891,1876,624,1200,267,676,476,681,392,889,1281,489,233,117,570,532,2525,.475,.520,.395,.699
301,2023-24,Idaho,11,32,11,21,.344,789,1736,553,1067,236,669,464,636,284,801,1085,422,208,111,355,485,2278,.454,.518,.353,.730
302,2023-24,Lafayette,11,32,11,21,.344,752,1801,515,1109,237,692,413,559,323,861,1184,387,201,99,376,471,2154,.418,.464,.342,.739
303,2023-24,Louisiana–Monroe,11,30,11,19,.367,747,1718,474,942,273,776,466,632,306,741,1047,439,208,112,368,549,2233,.435,.503,.352,.737
304,2023-24,UMBC,11,32,11,21,.344,948,2131,706,1362,242,769,445,609,385,875,1260,431,259,98,364,503,2583,.445,.518,.315,.731
305,2023-24,Morgan State,11,31,11,20,.355,846,1902,636,1290,210,612,500,730,413,746,1159,405,253,114,401,489,2402,.445,.493,.343,.685
306,2023-24,Northern Illinois,11,31,11,20,.355,853,1898,606,1217,247,681,446,655,359,782,1141,457,210,77,338,581,2399,.449,.498,.363,.681
307,2023-24,Pennsylvania,11,29,11,18,.379,782,1721,514,973,268,748,325,458,268,707,975,439,171,89,289,431,2157,.454,.528,.358,.710
308,2023-24,Rice,11,32,11,21,.344,875,1941,594,1193,281,748,390,525,334,804,1138,475,233,110,328,500,2421,.451,.498,.376,.743
309,2023-24,UTSA,11,32,11,21,.344,908,2032,628,1271,280,761,495,699,348,873,1221,477,195,144,303,568,2591,.447,.494,.368,.708
310,2023-24,Army,10,32,10,22,.313,734,1712,513,1033,221,679,370,526,266,820,1086,413,224,95,348,478,2059,.429,.497,.325,.703
311,2023-24,Charleston Southern,10,30,10,20,.333,809,1795,634,1232,175,563,417,588,307,778,1085,351,187,82,285,471,2210,.451,.515,.311,.709
312,2023-24,Holy Cross,10,33,10,23,.303,878,1922,588,1164,290,758,416,574,311,859,1170,464,217,104,278,467,2462,.457,.505,.383,.725
313,2023-24,New Orleans,10,33,10,23,.303,937,1997,723,1366,214,631,534,738,403,911,1314,502,210,132,483,665,2622,.469,.529,.339,.724
314,2023-24,Prairie View A&M,10,31,10,21,.323,808,1708,613,1147,195,561,557,792,332,823,1155,400,211,127,516,597,2368,.473,.534,.348,.703
315,2023-24,Robert Morris,10,32,10,22,.313,860,1865,642,1221,218,644,487,672,301,767,1068,437,235,85,348,496,2425,.461,.526,.339,.725
316,2023-24,Sacramento State,10,34,10,24,.294,859,1854,608,1134,251,720,425,593,264,727,991,447,253,102,350,574,2394,.463,.536,.349,.717
317,2023-24,USC Upstate,10,30,10,20,.333,737,1649,548,1050,189,599,525,738,333,805,1138,336,183,91,403,504,2188,.447,.522,.316,.711
318,2023-24,Southern Utah,10,31,10,21,.323,904,1894,726,1372,178,522,420,590,349,809,1158,420,213,107,388,599,2406,.477,.529,.341,.712
319,2023-24,Tennessee Tech,10,31,10,21,.323,857,1867,614,1177,243,690,332,427,288,825,1113,465,212,100,323,483,2289,.459,.522,.352,.778
320,2023-24,William & Mary,10,33,10,23,.303,840,1890,610,1195,230,695,470,639,321,871,1192,387,190,128,323,556,2380,.444,.510,.331,.736
321,2023-24,Air Force,9,31,9,22,.290,774,1631,555,1033,219,598,476,637,297,719,1016,386,178,96,348,495,2243,.475,.537,.366,.747
322,2023-24,Central Arkansas,9,32,9,23,.281,869,1933,567,1121,302,812,462,638,342,849,1191,418,244,100,367,504,2502,.450,.506,.372,.724
323,2023-24,Coastal Carolina,9,31,9,22,.290,856,2035,548,1100,308,935,414,602,382,790,1172,478,263,108,293,511,2434,.421,.498,.329,.688
324,2023-24,Georgetown,9,32,9,23,.281,901,1841,653,1138,248,703,442,618,310,777,1087,500,240,125,356,537,2492,.489,.574,.353,.715
325,2023-24,Georgia Southern,9,33,9,24,.273,887,1947,636,1239,251,708,590,838,400,858,1258,439,246,136,401,512,2615,.456,.513,.355,.704
326,2023-24,Hampton,9,33,9,24,.273,901,2064,639,1244,262,820,456,606,371,862,1233,441,236,90,359,532,2520,.437,.514,.320,.752
327,2023-24,Lindenwood,9,31,9,22,.290,781,1691,540,1044,241,647,463,640,281,838,1119,400,192,118,388,569,2266,.462,.517,.372,.723
328,2023-24,Maryland Eastern Shore,9,29,9,20,.310,722,1650,530,1065,192,585,410,602,322,757,1079,356,211,86,395,473,2046,.438,.498,.328,.681
329,2023-24,Northwestern State,9,32,9,23,.281,840,1860,617,1168,223,692,526,755,390,822,1212,423,230,139,429,564,2429,.452,.528,.322,.697
330,2023-24,San Jose State,9,32,9,23,.281,854,1804,607,1166,247,638,448,642,307,840,1147,465,154,91,343,460,2403,.473,.521,.387,.698
331,2023-24,Southeast Missouri State,9,31,9,22,.290,802,1733,642,1211,160,522,514,736,275,845,1120,387,206,104,392,508,2278,.463,.530,.307,.698
332,2023-24,Vanderbilt,9,32,9,23,.281,858,1881,580,1137,278,744,434,555,314,875,1189,473,181,112,347,558,2428,.456,.510,.374,.782
333,2023-24,West Virginia,9,32,9,23,.281,878,1969,582,1123,296,846,407,553,343,804,1147,498,242,124,332,586,2459,.446,.518,.350,.736
334,2023-24,Bellarmine,8,31,8,23,.258,818,1813,539,1013,279,800,405,551,298,837,1135,416,145,94,315,423,2320,.451,.532,.349,.735
335,2023-24,Incarnate Word,8,31,8,23,.258,841,1871,613,1232,228,639,526,740,335,765,1100,444,261,120,346,545,2436,.449,.498,.357,.711
336,2023-24,Louisville,8,32,8,24,.250,894,1890,619,1150,275,740,467,638,297,812,1109,494,242,123,366,608,2530,.473,.538,.372,.732
337,2023-24,Michigan,8,32,8,24,.250,926,1988,692,1339,234,649,442,606,347,770,1117,430,245,123,306,541,2528,.466,.517,.361,.729
338,2023-24,Missouri,8,32,8,24,.250,809,1818,560,1094,249,724,571,771,388,800,1188,427,206,108,409,547,2438,.445,.512,.344,.741
339,2023-24,Saint Francis (PA),8,30,8,22,.267,769,1685,547,1045,222,640,421,601,308,716,1024,400,209,124,356,497,2181,.456,.523,.347,.700
340,2023-24,Southern Indiana,8,32,8,24,.250,757,1781,542,1124,215,657,606,826,319,835,1154,385,213,105,384,597,2335,.425,.482,.327,.734
341,2023-24,LIU,7,29,7,22,.241,779,1713,596,1125,183,588,486,703,299,798,1097,428,251,121,330,462,2227,.455,.530,.311,.691
342,2023-24,Loyola (MD),7,32,7,25,.219,831,1785,595,1126,236,659,403,577,267,782,1049,431,234,118,331,536,2301,.466,.528,.358,.698
343,2023-24,Manhattan,7,30,7,23,.233,847,1827,620,1210,227,617,354,482,313,826,1139,509,243,122,356,413,2275,.464,.512,.368,.734
344,2023-24,NJIT,7,28,7,21,.250,735,1598,537,1030,198,568,433,626,306,753,1059,397,170,98,331,444,2101,.460,.521,.349,.692
345,2023-24,North Carolina A&T,7,32,7,25,.219,926,1931,673,1212,253,719,389,570,371,935,1306,491,169,113,347,534,2494,.480,.555,.352,.682
346,2023-24,Old Dominion,7,32,7,25,.219,825,1893,545,1099,280,794,534,744,362,933,1295,471,193,133,415,490,2464,.436,.496,.353,.718
347,2023-24,Valparaiso,7,32,7,25,.219,893,1870,659,1209,234,661,396,571,322,911,1233,487,205,80,396,491,2416,.478,.545,.354,.694
348,2023-24,Dartmouth,6,27,6,21,.222,719,1584,474,911,245,673,257,364,220,718,938,381,208,76,252,431,1940,.454,.520,.364,.706
349,2023-24,Florida A&M,6,29,6,23,.207,777,1732,551,1106,226,626,460,685,331,728,1059,378,242,110,334,436,2240,.449,.498,.361,.672
350,2023-24,Houston Christian,6,29,6,23,.207,908,1915,688,1267,220,648,384,533,345,764,1109,471,266,139,300,519,2420,.474,.543,.340,.720
351,2023-24,IUPUI,6,32,6,26,.188,927,1828,669,1143,258,685,442,610,337,727,1064,513,235,102,432,534,2554,.507,.585,.377,.725
352,2023-24,Pacific,6,32,6,26,.188,903,1867,642,1128,261,739,486,665,324,889,1213,463,199,105,369,588,2553,.484,.569,.353,.731
353,2023-24,Texas–Rio Grande Valley,6,31,6,25,.194,890,1898,669,1260,221,638,472,644,350,873,1223,539,229,139,448,589,2473,.469,.531,.346,.733
354,2023-24,Buffalo,4,31,4,27,.129,913,1926,663,1238,250,688,395,553,328,812,1140,488,238,91,331,455,2471,.474,.536,.363,.714
355,2023-24,Cal Poly,4,32,4,28,.125,817,1778,626,1235,191,543,546,744,360,872,1232,382,207,102,380,563,2371,.460,.507,.352,.734
356,2023-24,Siena,4,32,4,28,.125,880,1922,649,1266,231,656,391,538,344,756,1100,441,291,107,318,515,2382,.458,.513,.352,.727
357,2023-24,Stonehill,4,31,4,27,.129,826,1875,518,1008,308,867,400,548,346,864,1210,499,244,129,367,438,2360,.441,.514,.355,.730
358,2023-24,VMI,4,32,4,28,.125,969,2092,676,1271,293,821,413,628,361,889,1250,491,292,101,375,507,2644,.463,.532,.357,.658
359,2023-24,DePaul,3,32,3,29,.094,949,1948,644,1147,305,801,413,554,343,826,1169,552,246,114,318,539,2616,.487,.561,.381,.745
360,2023-24,Coppin State,2,29,2,27,.069,723,1613,514,1007,209,606,457,618,371,764,1135,424,259,98,431,455,2112,.448,.510,.345,.739
361,2023-24,Detroit Mercy,1,32,1,31,.031,921,1878,662,1179,259,699,467,599,361,811,1172,482,197,98,380,515,2568,.490,.561,.371,.780
362,2023-24,Mississippi Valley State,1,31,1,30,.032,835,1711,604,1087,231,624,508,711,340,771,1111,452,273,98,354,519,2409,.488,.556,.370,.714