Rk,Season,Team,W,G,W,L,W/L%,MP,Team Total FG,Team Total FGA,Team Total 2P,Team Total 2PA,Team Total 3P,Team Total 3PA,Team Total FT,Team Total FTA,Team Total ORB,Team Total DRB,Team Total TRB,Team Total AST,Team Total STL,Team Total BLK,Team Total TOV,Team Total PF,Team Total PTS,Team Shooting Total FG%,Team Shooting Total 2P%,Team Shooting Total 3P%,Team Shooting Total FT%,Team Shooting Total TS%,Team Shooting Total eFG%
1,2023-24,Connecticut,37,40,37,3,.925,8000,1177,2367,837,1416,340,951,562,756,469,1084,1553,748,246,217,383,650,3256,.497,.591,.358,.743,.597,.569
2,2023-24,Purdue,34,39,34,5,.872,7875,1109,2272,791,1484,318,788,675,938,476,1101,1577,720,212,142,442,536,3211,.488,.533,.404,.720,.591,.558
3,2023-24,Houston,32,37,32,5,.865,7475,981,2233,695,1412,286,821,472,687,497,877,1374,484,362,178,330,658,2720,.439,.492,.348,.687,.531,.503
4,2023-24,Indiana State,32,39,32,7,.821,7825,1141,2258,714,1139,427,1119,600,754,279,1104,1383,698,238,72,452,638,3309,.505,.627,.382,.796,.632,.600
5,2023-24,James Madison,32,36,32,4,.889,7275,1073,2254,766,1402,307,852,542,771,415,975,1390,577,325,113,392,621,2995,.476,.546,.360,.703,.572,.544
6,2023-24,Grand Canyon,30,35,30,5,.857,7025,924,2008,679,1279,245,729,676,903,412,923,1335,424,289,192,430,625,2769,.460,.531,.336,.749,.568,.521
7,2023-24,McNeese State,30,34,30,4,.882,6800,973,1997,716,1326,257,671,516,745,382,844,1226,506,350,115,329,588,2719,.487,.540,.383,.693,.578,.552
8,2023-24,Illinois,29,38,29,9,.763,7650,1104,2356,787,1448,317,908,643,874,486,1068,1554,506,166,143,401,576,3168,.469,.544,.349,.736,.572,.536
9,2023-24,Iowa State,29,37,29,8,.784,7400,1002,2164,756,1477,246,687,537,765,393,861,1254,582,382,113,387,610,2787,.463,.512,.358,.702,.551,.520
10,2023-24,North Carolina,29,37,29,8,.784,7425,1046,2323,745,1484,301,839,639,842,452,1068,1520,536,214,151,373,611,3032,.450,.502,.359,.759,.557,.515
11,2023-24,Samford,29,35,29,6,.829,7000,1054,2152,703,1263,351,889,553,765,371,881,1252,619,347,131,455,667,3012,.490,.557,.395,.723,.599,.571
12,2023-24,Drake,28,35,28,7,.800,7175,992,2079,692,1260,300,819,513,681,278,924,1202,559,226,56,337,570,2797,.477,.549,.366,.753,.582,.549
13,2023-24,Utah State,28,35,28,7,.800,7100,999,2036,773,1358,226,678,564,783,332,922,1254,572,238,148,385,594,2788,.491,.569,.333,.720,.579,.546
14,2023-24,Vermont,28,35,28,7,.800,7025,900,1980,600,1102,300,878,406,567,268,944,1212,478,206,136,322,488,2506,.455,.544,.342,.716,.557,.530
15,2023-24,Appalachian State,27,34,27,7,.794,6950,997,2100,773,1426,224,674,447,657,373,1043,1416,498,209,230,365,449,2665,.475,.542,.332,.680,.552,.528
16,2023-24,Arizona,27,36,27,9,.750,7325,1124,2321,840,1545,284,776,605,844,471,1062,1533,665,300,133,430,590,3137,.484,.544,.366,.717,.576,.545
17,2023-24,Auburn,27,35,27,8,.771,7000,1010,2121,730,1326,280,795,609,812,393,930,1323,622,258,215,374,678,2909,.476,.551,.352,.750,.580,.542
18,2023-24,College of Charleston,27,35,27,8,.771,7025,1006,2278,638,1206,368,1072,452,626,457,935,1392,536,219,108,348,558,2832,.442,.529,.343,.722,.550,.522
19,2023-24,Duke,27,36,27,9,.750,7200,1004,2112,706,1321,298,791,524,725,383,936,1319,551,235,132,349,571,2830,.475,.534,.377,.723,.576,.546
20,2023-24,Gonzaga,27,35,27,8,.771,7000,1120,2162,877,1488,243,674,476,660,379,976,1355,585,233,135,342,546,2959,.518,.589,.361,.721,.598,.574
21,2023-24,High Point,27,36,27,9,.750,7326,999,2163,699,1284,300,879,722,928,476,964,1440,427,182,120,399,651,3020,.462,.544,.341,.778,.580,.531
22,2023-24,Marquette,27,37,27,10,.730,7425,1078,2256,751,1328,327,928,405,576,322,890,1212,587,317,131,369,556,2888,.478,.566,.352,.703,.571,.550
23,2023-24,Tennessee,27,36,27,9,.750,7200,979,2223,664,1308,315,915,563,750,419,974,1393,600,280,166,367,629,2836,.440,.508,.344,.751,.550,.511
24,2023-24,Colorado,26,37,26,11,.703,7475,1049,2121,795,1472,254,649,583,744,368,999,1367,600,221,80,467,548,2935,.495,.540,.391,.784,.593,.554
25,2023-24,Morehead State,26,35,26,9,.743,7000,944,2021,615,1109,329,912,418,592,407,965,1372,526,206,160,413,553,2635,.467,.555,.361,.706,.572,.548
26,2023-24,Nevada,26,34,26,8,.765,6825,881,1860,654,1235,227,625,593,824,302,865,1167,511,214,121,342,599,2582,.474,.530,.363,.720,.573,.535
27,2023-24,New Mexico,26,36,26,10,.722,7200,1067,2343,834,1632,233,711,549,776,462,967,1429,524,312,178,361,632,2916,.455,.511,.328,.707,.538,.505
28,2023-24,NC State,26,41,26,15,.634,8300,1117,2483,832,1656,285,827,582,794,415,1032,1447,536,297,148,392,664,3101,.450,.502,.345,.733,.542,.507
29,2023-24,St. Mary's (CA),26,34,26,8,.765,6850,936,2007,678,1274,258,733,386,571,448,897,1345,550,223,130,347,556,2516,.466,.532,.352,.676,.552,.531
30,2023-24,San Diego State,26,37,26,11,.703,7525,954,2167,695,1345,259,822,575,784,432,966,1398,481,275,149,413,647,2742,.440,.517,.315,.733,.540,.500
31,2023-24,South Carolina,26,34,26,8,.765,6850,865,1970,591,1161,274,809,446,627,387,823,1210,524,162,108,344,550,2450,.439,.509,.339,.711,.540,.509
32,2023-24,Alabama,25,37,25,12,.676,7450,1136,2385,723,1277,413,1108,650,842,472,995,1467,587,256,162,438,734,3335,.476,.566,.373,.772,.599,.563
33,2023-24,Colgate,25,35,25,10,.714,7000,929,1979,657,1222,272,757,368,540,286,959,1245,526,227,122,368,468,2498,.469,.538,.359,.681,.559,.538
34,2023-24,Colorado State,25,36,25,11,.694,7250,980,2024,716,1243,264,781,483,642,283,920,1203,648,226,113,376,613,2707,.484,.576,.338,.752,.581,.549
35,2023-24,Creighton,25,35,25,10,.714,7175,1016,2101,641,1083,375,1018,408,518,294,1040,1334,588,134,143,372,403,2815,.484,.592,.368,.788,.600,.573
36,2023-24,Dayton,25,33,25,8,.758,6625,831,1752,521,975,310,777,476,643,265,842,1107,483,182,129,343,447,2448,.474,.534,.399,.740,.595,.563
37,2023-24,Duquesne,25,37,25,12,.676,7398,921,2110,642,1289,279,821,490,681,389,899,1288,497,277,160,433,634,2611,.436,.498,.340,.720,.536,.503
38,2023-24,Florida Atlantic,25,34,25,9,.735,6950,992,2074,708,1264,284,810,521,724,396,898,1294,505,244,105,388,546,2789,.478,.560,.351,.720,.577,.547
39,2023-24,Seton Hall,25,37,25,12,.676,7500,987,2184,758,1503,229,681,527,674,445,934,1379,481,280,179,466,562,2730,.452,.504,.336,.782,.545,.504
40,2023-24,South Florida,25,33,25,8,.758,6600,837,1900,542,1096,295,804,530,719,328,861,1189,491,229,112,356,568,2499,.441,.495,.367,.737,.557,.518
41,2023-24,Tarleton State,25,35,25,10,.714,7025,951,2091,748,1468,203,623,488,645,379,813,1192,482,308,124,395,605,2593,.455,.510,.326,.757,.541,.503
42,2023-24,Washington State,25,35,25,10,.714,7050,948,2046,725,1388,223,658,455,646,391,926,1317,435,181,172,383,582,2574,.463,.522,.339,.704,.547,.518
43,2023-24,Akron,24,35,24,11,.686,7025,915,2018,635,1155,280,863,467,642,363,915,1278,455,197,100,394,583,2577,.453,.550,.324,.727,.555,.523
44,2023-24,Baylor,24,35,24,11,.686,7150,967,2001,666,1228,301,773,579,791,399,830,1229,514,236,110,421,577,2814,.483,.542,.389,.732,.592,.558
45,2023-24,UC Irvine,24,34,24,10,.706,6850,967,2035,770,1470,197,565,508,675,360,927,1287,529,219,113,393,624,2639,.475,.524,.349,.753,.560,.524
46,2023-24,Clemson,24,36,24,12,.667,7250,991,2115,695,1271,296,844,507,650,326,982,1308,533,165,138,363,585,2785,.469,.547,.351,.780,.575,.539
47,2023-24,Fairfield,24,37,24,13,.649,7400,991,2221,649,1278,342,943,470,620,368,871,1239,497,314,82,394,531,2794,.446,.508,.363,.758,.555,.523
48,2023-24,Florida,24,36,24,12,.667,7325,1077,2351,797,1539,280,812,646,903,527,995,1522,546,241,189,420,664,3080,.458,.518,.345,.715,.554,.518
49,2023-24,Montana,24,36,24,12,.667,7250,1007,2075,730,1301,277,774,477,602,299,928,1227,537,172,107,371,600,2768,.485,.561,.358,.792,.586,.552
50,2023-24,Norfolk State,24,35,24,11,.686,7025,908,1978,685,1322,223,656,569,788,384,821,1205,436,308,108,425,650,2608,.459,.518,.340,.722,.554,.515
51,2023-24,Oakland,24,36,24,12,.667,7325,966,2166,648,1271,318,895,501,667,383,909,1292,522,237,100,396,544,2751,.446,.510,.355,.751,.554,.519
52,2023-24,Oregon,24,36,24,12,.667,7267,982,2145,719,1367,263,778,494,687,357,881,1238,497,258,131,366,591,2721,.458,.526,.338,.719,.551,.519
53,2023-24,Princeton,24,29,24,5,.828,5800,777,1695,473,841,304,854,377,468,244,722,966,422,173,55,237,392,2235,.458,.562,.356,.806,.583,.548
54,2023-24,Quinnipiac,24,34,24,10,.706,6825,938,2089,684,1366,254,723,500,645,369,887,1256,479,260,125,423,552,2630,.449,.501,.351,.775,.549,.510
55,2023-24,VCU,24,38,24,14,.632,7650,906,2059,584,1148,322,911,563,721,343,993,1336,515,246,167,462,625,2697,.440,.509,.353,.781,.562,.518
56,2023-24,UAB,23,35,23,12,.657,7100,937,2085,722,1427,215,658,622,834,451,878,1329,473,236,159,406,555,2711,.449,.506,.327,.746,.546,.501
57,2023-24,Bradley,23,35,23,12,.657,7075,943,1999,637,1164,306,835,400,550,324,890,1214,463,250,144,423,578,2592,.472,.547,.366,.727,.573,.548
58,2023-24,Brigham Young,23,34,23,11,.676,6800,992,2155,614,1068,378,1087,406,547,405,938,1343,629,202,101,364,602,2768,.460,.575,.348,.742,.573,.548
59,2023-24,Purdue Fort Wayne,23,36,23,13,.639,7250,1043,2231,703,1289,340,942,460,654,302,871,1173,490,332,111,375,612,2886,.468,.545,.361,.703,.568,.544
60,2023-24,Kansas,23,34,23,11,.676,6825,960,1967,765,1380,195,587,454,630,280,948,1228,647,243,133,397,502,2569,.488,.554,.332,.721,.567,.538
61,2023-24,Kentucky,23,33,23,10,.697,6675,1055,2132,728,1332,327,800,501,649,332,909,1241,579,248,207,352,577,2938,.495,.547,.409,.772,.602,.572
62,2023-24,Loyola Chicago,23,33,23,10,.697,6650,855,1900,581,1125,274,775,428,629,317,896,1213,547,233,166,423,643,2412,.450,.516,.354,.680,.548,.522
63,2023-24,Nebraska,23,34,23,11,.676,6875,912,2017,593,1124,319,893,500,658,326,954,1280,521,214,89,377,539,2643,.452,.528,.357,.760,.567,.531
64,2023-24,Richmond,23,33,23,10,.697,6625,874,1889,632,1221,242,668,382,522,188,893,1081,436,220,97,285,468,2372,.463,.518,.362,.732,.555,.527
65,2023-24,San Francisco,23,34,23,11,.676,6850,995,2044,702,1219,293,825,360,477,320,839,1159,554,279,117,392,622,2643,.487,.576,.355,.755,.582,.558
66,2023-24,Seattle,23,37,23,14,.622,7550,956,2143,675,1332,281,811,537,730,373,996,1369,481,215,106,470,683,2730,.446,.507,.346,.736,.548,.512
67,2023-24,Texas Tech,23,34,23,11,.676,6825,877,1943,588,1139,289,804,518,664,338,850,1188,501,204,86,378,508,2561,.451,.516,.359,.780,.567,.526
68,2023-24,Virginia,23,34,23,11,.676,6875,808,1887,588,1272,220,615,304,477,298,809,1107,509,239,169,274,460,2140,.428,.462,.358,.637,.506,.486
69,2023-24,Yale,23,33,23,10,.697,6700,919,1969,678,1282,241,687,386,546,326,879,1205,495,204,105,316,499,2465,.467,.529,.351,.707,.553,.528
70,2023-24,Boise State,22,33,22,11,.667,6650,858,1913,600,1154,258,759,505,686,384,847,1231,404,189,78,366,550,2479,.449,.520,.340,.736,.554,.516
71,2023-24,Cincinnati,22,37,22,15,.595,7500,1023,2310,743,1461,280,849,439,638,492,968,1460,540,240,164,445,555,2765,.443,.509,.330,.688,.529,.503
72,2023-24,Cornell,22,30,22,8,.733,6000,895,1836,585,944,310,892,363,502,287,776,1063,544,250,79,366,549,2463,.487,.620,.348,.723,.594,.572
73,2023-24,Louisiana Tech,22,32,22,10,.688,6450,823,1802,594,1169,229,633,517,738,376,868,1244,404,240,161,398,500,2392,.457,.508,.362,.701,.556,.520
74,2023-24,UMass Lowell,22,32,22,10,.688,6450,913,1924,727,1358,186,566,549,746,367,938,1305,406,222,157,425,480,2561,.475,.535,.329,.736,.562,.523
75,2023-24,Memphis,22,32,22,10,.688,6450,897,1952,631,1193,266,759,514,709,383,802,1185,438,274,145,419,551,2576,.460,.529,.350,.725,.563,.528
76,2023-24,UNC Asheville,22,34,22,12,.647,6875,906,1950,629,1191,277,759,593,799,319,863,1182,534,203,146,403,581,2682,.465,.528,.365,.742,.576,.536
77,2023-24,Northwestern,22,34,22,12,.647,6925,892,1960,614,1247,278,713,431,573,290,778,1068,530,239,106,300,598,2493,.455,.492,.390,.752,.558,.526
78,2023-24,Ohio State,22,36,22,14,.611,7280,957,2126,703,1390,254,736,550,717,394,941,1335,507,201,166,381,611,2718,.450,.506,.345,.767,.551,.510
79,2023-24,Pittsburgh,22,33,22,11,.667,6600,873,1999,556,1112,317,887,432,610,376,847,1223,452,208,147,297,510,2495,.437,.500,.357,.708,.545,.516
80,2023-24,South Dakota State,22,35,22,13,.629,7050,977,2029,677,1206,300,823,421,593,289,951,1240,450,213,112,395,501,2675,.482,.561,.365,.710,.579,.555
81,2023-24,Stetson,22,35,22,13,.629,7025,950,2053,637,1196,313,857,474,619,339,877,1216,465,187,108,369,516,2687,.463,.533,.365,.766,.572,.539
82,2023-24,Utah,22,37,22,15,.595,7475,1082,2309,737,1376,345,933,406,625,370,1068,1438,654,217,154,426,587,2915,.469,.536,.370,.650,.559,.543
83,2023-24,Western Carolina,22,32,22,10,.688,6475,902,1963,641,1250,261,713,394,553,335,934,1269,367,141,103,330,536,2459,.460,.513,.366,.712,.552,.526
84,2023-24,Western Kentucky,22,34,22,12,.647,6806,996,2138,763,1452,233,686,503,699,361,997,1358,454,260,110,470,625,2728,.466,.525,.340,.720,.552,.520
85,2023-24,Wisconsin,22,36,22,14,.611,7275,952,2067,696,1333,256,734,528,699,362,862,1224,458,224,59,358,594,2688,.461,.522,.349,.755,.560,.522
86,2023-24,Youngstown State,22,32,22,10,.688,6450,931,2064,649,1192,282,872,454,589,409,870,1279,490,198,156,353,520,2598,.451,.544,.323,.771,.554,.519
87,2023-24,Little Rock,21,34,21,13,.618,6850,957,2024,740,1395,217,629,497,664,369,875,1244,502,203,160,417,596,2628,.473,.530,.345,.748,.562,.526
88,2023-24,UC San Diego,21,33,21,12,.636,6675,884,1933,591,1115,293,818,469,624,317,830,1147,429,205,91,320,532,2530,.457,.530,.358,.752,.567,.533
89,2023-24,Chattanooga,21,33,21,12,.636,6675,892,1915,543,944,349,971,448,601,305,901,1206,447,208,121,393,524,2581,.466,.575,.359,.745,.586,.557
90,2023-24,Cleveland State,21,36,21,15,.583,7250,1005,2246,773,1549,232,697,475,711,455,812,1267,477,297,140,370,658,2717,.447,.499,.333,.668,.526,.499
91,2023-24,Eastern Washington,21,32,21,11,.656,6425,894,1783,621,1034,273,749,525,681,258,825,1083,562,191,115,422,579,2586,.501,.601,.364,.771,.614,.578
92,2023-24,Grambling State,21,36,21,15,.583,7291,860,1955,675,1408,185,547,531,750,346,812,1158,354,266,115,473,577,2436,.440,.479,.338,.708,.527,.487
93,2023-24,Long Beach State,21,36,21,15,.583,7250,993,2239,799,1602,194,637,606,855,450,949,1399,550,285,151,455,620,2786,.444,.499,.305,.709,.527,.487
94,2023-24,Longwood,21,35,21,14,.600,7100,931,2053,730,1463,201,590,552,804,470,873,1343,446,244,88,444,639,2615,.453,.499,.341,.687,.537,.502
95,2023-24,Merrimack,21,33,21,12,.636,6650,795,1814,554,1035,241,779,452,620,260,774,1034,409,325,121,436,532,2283,.438,.535,.309,.729,.541,.505
96,2023-24,Mississippi State,21,35,21,14,.600,7025,917,2027,666,1246,251,781,508,758,436,897,1333,491,284,107,455,580,2593,.452,.535,.321,.670,.543,.514
97,2023-24,UNLV,21,34,21,13,.618,6900,906,1959,675,1274,231,685,458,633,350,814,1164,450,208,154,376,540,2501,.462,.530,.337,.724,.553,.521
98,2023-24,UNC Greensboro,21,32,21,11,.656,6450,865,1878,543,1066,322,812,370,507,319,814,1133,473,223,81,349,549,2422,.461,.509,.397,.730,.572,.546
99,2023-24,UNC Wilmington,21,31,21,10,.677,6300,863,1871,605,1130,258,741,477,628,330,736,1066,379,202,75,266,527,2461,.461,.535,.348,.760,.567,.530
100,2023-24,Providence,21,35,21,14,.600,7075,891,2011,601,1120,290,891,462,640,321,936,1257,477,225,161,424,552,2534,.443,.537,.325,.722,.547,.515
101,2023-24,Saint Joseph's,21,35,21,14,.600,7050,928,2084,577,1088,351,996,434,598,353,900,1253,513,247,133,401,534,2641,.445,.530,.352,.726,.558,.530
102,2023-24,Sam Houston State,21,33,21,12,.636,6650,828,1948,583,1251,245,697,480,663,393,862,1255,425,226,75,435,596,2381,.425,.466,.352,.724,.526,.488
103,2023-24,UT Martin,21,32,21,11,.656,6450,908,2045,629,1266,279,779,514,667,325,994,1319,415,199,89,366,455,2609,.444,.497,.358,.771,.552,.512
104,2023-24,Texas,21,34,21,13,.618,6825,932,1988,687,1297,245,691,454,600,339,840,1179,512,244,149,393,587,2563,.469,.530,.355,.757,.564,.530
105,2023-24,Texas A&M,21,36,21,15,.583,7250,926,2304,671,1435,255,869,629,890,627,914,1541,412,250,108,346,611,2736,.402,.468,.293,.707,.502,.457
106,2023-24,Texas A&M–Corpus Christi,21,33,21,12,.636,6675,889,2046,706,1430,183,616,519,738,438,890,1328,485,291,96,400,689,2480,.435,.494,.297,.703,.517,.479
107,2023-24,TCU,21,34,21,13,.618,6900,964,2089,740,1457,224,632,535,732,433,830,1263,575,305,128,438,593,2687,.461,.508,.354,.731,.551,.515
108,2023-24,Wake Forest,21,35,21,14,.600,7050,968,2042,690,1278,278,764,519,653,296,901,1197,429,207,145,375,542,2733,.474,.540,.364,.795,.581,.542
109,2023-24,Western Illinois,21,33,21,12,.636,6650,826,1936,631,1325,195,611,425,691,482,915,1397,421,173,185,436,470,2272,.427,.476,.319,.615,.502,.477
110,2023-24,Arkansas State,20,37,20,17,.541,7425,1021,2313,680,1322,341,991,534,761,489,930,1419,536,207,163,414,644,2917,.441,.514,.344,.702,.545,.515
111,2023-24,Belmont,20,33,20,13,.606,6626,922,1939,621,1128,301,811,425,588,237,893,1130,504,248,101,402,511,2570,.476,.551,.371,.723,.579,.553
112,2023-24,Boston College,20,36,20,16,.556,7250,982,2155,683,1329,299,826,404,539,338,933,1271,509,212,124,376,566,2667,.456,.514,.362,.750,.553,.525
113,2023-24,Bowling Green,20,34,20,14,.588,6925,882,2045,666,1315,216,730,522,730,386,906,1292,383,221,96,392,533,2502,.431,.506,.296,.715,.523,.484
114,2023-24,Bryant,20,33,20,13,.606,6650,954,2087,681,1281,273,806,417,623,259,987,1246,487,230,213,393,557,2598,.457,.532,.339,.669,.545,.523
115,2023-24,UC Davis,20,33,20,13,.606,6650,799,1808,569,1124,230,684,523,699,327,775,1102,411,257,116,444,633,2351,.442,.506,.336,.748,.549,.506
116,2023-24,Central Connecticut State,20,31,20,11,.645,6250,810,1798,602,1153,208,645,409,577,298,813,1111,444,232,150,349,423,2237,.451,.522,.322,.709,.540,.508
117,2023-24,Drexel,20,32,20,12,.625,6475,861,1886,645,1258,216,628,408,565,369,884,1253,406,161,127,346,491,2346,.457,.513,.344,.722,.544,.514
118,2023-24,George Mason,20,32,20,12,.625,6400,791,1720,573,1083,218,637,473,637,323,829,1152,365,175,110,378,527,2273,.460,.529,.342,.743,.562,.523
119,2023-24,Georgia,20,37,20,17,.541,7425,943,2195,643,1312,300,883,578,803,366,953,1319,436,237,121,421,598,2764,.430,.490,.340,.720,.536,.498
120,2023-24,Hawaii,20,34,20,14,.588,6875,843,1841,578,1065,265,776,507,706,287,868,1155,414,157,88,423,594,2458,.458,.543,.341,.718,.565,.530
121,2023-24,Hofstra,20,33,20,13,.606,6625,904,1918,574,1028,330,890,311,413,254,827,1081,507,204,115,344,480,2449,.471,.558,.371,.753,.579,.557
122,2023-24,Lipscomb,20,32,20,12,.625,6400,960,1946,663,1165,297,781,409,533,244,820,1064,465,196,110,321,414,2626,.493,.569,.380,.767,.597,.570
123,2023-24,Massachusetts,20,31,20,11,.645,6225,858,1904,649,1236,209,668,476,681,416,772,1188,483,236,93,345,579,2401,.451,.525,.313,.699,.539,.506
124,2023-24,Michigan State,20,35,20,15,.571,7025,949,2058,722,1432,227,626,426,602,353,862,1215,558,248,132,350,581,2551,.461,.504,.363,.708,.544,.516
125,2023-24,Milwaukee,20,35,20,15,.571,7125,980,2198,703,1337,277,861,545,750,473,891,1364,498,208,155,439,635,2782,.446,.526,.322,.727,.545,.509
126,2023-24,Ole Miss,20,32,20,12,.625,6400,839,1876,598,1216,241,660,479,658,333,738,1071,484,251,184,344,522,2398,.447,.492,.365,.728,.548,.511
127,2023-24,Nicholls State,20,34,20,14,.588,7027,849,1909,565,1131,284,778,530,731,325,874,1199,387,229,140,450,636,2512,.445,.500,.365,.725,.557,.519
128,2023-24,Ohio,20,33,20,13,.606,6675,901,1987,607,1160,294,827,455,623,333,820,1153,464,235,118,321,562,2551,.453,.523,.356,.730,.559,.527
129,2023-24,Oklahoma,20,32,20,12,.625,6450,835,1797,596,1105,239,692,503,677,310,816,1126,427,189,104,399,515,2412,.465,.539,.345,.743,.569,.531
130,2023-24,Santa Clara,20,33,20,13,.606,6625,912,1984,641,1218,271,766,443,620,397,899,1296,497,158,89,422,584,2538,.460,.526,.354,.715,.557,.528
131,2023-24,SMU,20,33,20,13,.606,6625,934,2089,683,1354,251,735,416,606,480,834,1314,517,277,159,372,564,2535,.447,.504,.341,.686,.533,.507
132,2023-24,St. Bonaventure,20,33,20,13,.606,6675,853,1872,602,1185,251,687,467,603,320,767,1087,412,218,128,358,553,2424,.456,.508,.365,.774,.562,.523
133,2023-24,St. John's (NY),20,33,20,13,.606,6600,970,2139,733,1443,237,696,425,584,476,803,1279,518,232,180,360,593,2602,.453,.508,.341,.728,.538,.509
134,2023-24,St. Thomas,20,33,20,13,.606,6625,859,1824,560,995,299,829,385,528,255,772,1027,451,204,71,303,520,2402,.471,.563,.361,.729,.579,.553
135,2023-24,Stony Brook,20,35,20,15,.571,7150,921,2101,644,1326,277,775,454,614,336,944,1280,424,211,113,359,532,2573,.438,.486,.357,.739,.538,.504
136,2023-24,Syracuse,20,32,20,12,.625,6400,883,1915,664,1264,219,651,457,634,277,787,1064,442,290,129,364,493,2442,.461,.525,.336,.721,.551,.518
137,2023-24,UT Arlington,20,34,20,14,.588,6825,880,1981,575,1120,305,861,549,747,404,871,1275,536,241,130,526,706,2614,.444,.513,.354,.735,.560,.521
138,2023-24,Toledo,20,32,20,12,.625,6450,920,1926,713,1376,207,550,513,680,318,763,1081,430,233,64,342,498,2560,.478,.518,.376,.754,.569,.531
139,2023-24,Towson,20,34,20,14,.588,6875,818,1934,602,1275,216,659,444,672,491,846,1337,381,210,142,413,565,2296,.423,.472,.328,.661,.509,.479
140,2023-24,Troy,20,32,20,12,.625,6500,859,1950,583,1163,276,787,552,753,427,803,1230,438,331,105,441,611,2546,.441,.501,.351,.733,.552,.511
141,2023-24,Weber State,20,32,20,12,.625,6450,843,1797,592,1076,251,721,477,637,248,777,1025,390,221,53,316,495,2414,.469,.550,.348,.749,.575,.539
142,2023-24,Austin Peay,19,35,19,16,.543,7125,941,2105,664,1337,277,768,460,652,378,810,1188,388,250,95,308,615,2619,.447,.497,.361,.706,.542,.513
143,2023-24,Cal State Northridge,19,34,19,15,.559,6825,940,2065,775,1528,165,537,506,757,402,960,1362,472,253,114,481,707,2551,.455,.507,.307,.668,.526,.495
144,2023-24,Charlotte,19,31,19,12,.613,6250,748,1655,547,1020,201,635,434,576,260,746,1006,407,168,105,301,479,2131,.452,.536,.317,.753,.552,.513
145,2023-24,Delaware,19,33,19,14,.576,6625,891,1917,664,1239,227,678,407,576,304,874,1178,454,178,100,356,496,2416,.465,.536,.335,.707,.551,.524
146,2023-24,East Tennessee State,19,35,19,16,.543,7025,866,2131,594,1255,272,876,498,730,486,864,1350,399,269,163,433,638,2502,.406,.473,.311,.682,.505,.470
147,2023-24,Indiana,19,33,19,14,.576,6600,879,1848,713,1335,166,513,462,696,293,861,1154,504,171,133,400,559,2386,.476,.534,.324,.664,.548,.521
148,2023-24,Iowa,19,34,19,15,.559,6825,1025,2154,799,1510,226,644,551,712,333,877,1210,606,232,134,327,575,2827,.476,.529,.351,.774,.567,.528
149,2023-24,Kansas State,19,34,19,15,.559,6975,837,1919,586,1129,251,790,529,735,378,897,1275,475,202,139,503,596,2454,.436,.519,.318,.720,.541,.502
150,2023-24,Lamar,19,33,19,14,.576,6700,912,2025,664,1308,248,717,496,679,412,845,1257,544,233,123,426,615,2568,.450,.508,.346,.730,.547,.512
151,2023-24,Louisiana,19,33,19,14,.576,6600,919,2025,668,1282,251,743,415,569,371,762,1133,409,284,124,388,592,2504,.454,.521,.338,.729,.545,.516
152,2023-24,Minnesota,19,34,19,15,.559,6825,910,1930,642,1176,268,754,462,670,343,844,1187,588,214,150,408,547,2550,.472,.546,.355,.690,.567,.541
153,2023-24,North Texas,19,34,19,15,.559,6850,826,1907,542,1154,284,753,417,566,390,789,1179,378,241,101,378,571,2353,.433,.470,.377,.737,.541,.508
154,2023-24,Northern Colorado,19,33,19,14,.576,6800,969,1997,715,1267,254,730,425,583,270,887,1157,482,207,79,368,547,2617,.485,.564,.348,.729,.575,.549
155,2023-24,Northern Iowa,19,33,19,14,.576,6650,843,1849,605,1159,238,690,493,697,265,852,1117,414,206,85,340,547,2417,.456,.522,.345,.707,.554,.520
156,2023-24,Saint Peter's,19,33,19,14,.576,6625,720,1830,528,1240,192,590,508,713,411,750,1161,350,235,137,414,640,2140,.393,.426,.325,.712,.493,.446
157,2023-24,Southern Illinois,19,32,19,13,.594,6500,791,1746,527,985,264,761,479,629,270,785,1055,456,175,98,356,579,2325,.453,.535,.347,.762,.569,.529
158,2023-24,Virginia Tech,19,34,19,15,.559,6800,886,1905,610,1113,276,792,499,629,263,838,1101,514,180,83,376,540,2547,.465,.548,.348,.793,.578,.538
159,2023-24,Butler,18,33,18,15,.545,6750,922,2036,646,1258,276,778,424,536,308,854,1162,499,204,110,361,454,2544,.453,.514,.355,.791,.555,.521
160,2023-24,Central Michigan,18,32,18,14,.563,6575,790,1880,590,1220,200,660,347,526,339,823,1162,364,192,119,384,527,2127,.420,.484,.303,.660,.499,.473
161,2023-24,Green Bay,18,32,18,14,.563,6450,780,1742,495,902,285,840,364,504,283,778,1061,412,140,69,384,552,2209,.448,.549,.339,.722,.557,.530
162,2023-24,Howard,18,35,18,17,.514,7100,868,1932,587,1175,281,757,606,807,395,862,1257,485,212,98,541,661,2623,.449,.500,.371,.751,.566,.522
163,2023-24,Liberty,18,32,18,14,.563,6450,863,1848,539,968,324,880,312,472,279,808,1087,508,167,74,334,480,2362,.467,.557,.368,.661,.570,.555
164,2023-24,Marist,18,31,18,13,.581,6200,726,1638,514,1042,212,596,340,488,222,774,996,381,212,87,378,503,2004,.443,.493,.356,.697,.536,.508
165,2023-24,Monmouth,18,33,18,15,.545,6605,860,1998,608,1272,252,726,418,585,370,797,1167,432,236,114,345,559,2390,.430,.478,.347,.715,.525,.493
166,2023-24,North Carolina Central,18,31,18,13,.581,6250,823,1812,590,1131,233,681,496,714,349,748,1097,398,237,83,372,552,2375,.454,.522,.342,.695,.552,.518
167,2023-24,North Dakota,18,32,18,14,.563,6425,858,1934,594,1125,264,809,428,600,366,805,1171,371,202,96,324,485,2408,.444,.528,.326,.713,.543,.512
168,2023-24,Northern Kentucky,18,33,18,15,.545,6700,882,1935,673,1279,209,656,497,691,347,794,1141,456,284,86,407,543,2470,.456,.526,.319,.719,.546,.510
169,2023-24,San Diego,18,33,18,15,.545,6600,849,1978,616,1301,233,677,461,633,331,797,1128,432,239,126,437,628,2392,.429,.473,.344,.728,.525,.488
170,2023-24,Southern,18,32,18,14,.563,6450,807,1829,586,1145,221,684,440,653,312,708,1020,440,291,105,456,631,2275,.441,.512,.323,.674,.532,.502
171,2023-24,Stephen F. Austin,18,33,18,15,.545,6725,849,1890,646,1283,203,607,562,796,393,791,1184,422,295,93,530,697,2463,.449,.504,.334,.706,.543,.503
172,2023-24,Tennessee State,18,33,18,15,.545,6625,832,1881,615,1214,217,667,519,687,327,817,1144,396,220,116,436,644,2400,.442,.507,.325,.755,.544,.500
173,2023-24,UTEP,18,34,18,16,.529,6850,859,1922,665,1313,194,609,558,809,361,763,1124,439,389,97,500,677,2470,.447,.506,.319,.690,.535,.497
174,2023-24,Villanova,18,34,18,16,.529,6950,826,1945,511,1012,315,933,421,521,288,896,1184,437,197,81,327,520,2388,.425,.505,.338,.808,.545,.506
175,2023-24,Wright State,18,32,18,14,.563,6475,1033,1948,815,1379,218,569,483,638,290,821,1111,529,200,90,379,499,2767,.530,.591,.383,.757,.615,.586
176,2023-24,Bethune-Cookman,17,34,17,17,.500,6875,860,1994,661,1374,199,620,560,742,356,783,1139,414,351,117,471,696,2479,.431,.481,.321,.755,.528,.481
177,2023-24,UCF,17,33,17,16,.515,6625,817,1945,592,1247,225,698,507,723,408,835,1243,375,287,165,413,601,2366,.420,.475,.322,.701,.517,.478
178,2023-24,Denver,17,34,17,17,.500,6925,946,2103,652,1258,294,845,569,779,348,865,1213,444,211,132,340,573,2755,.450,.518,.348,.730,.557,.520
179,2023-24,Eastern Kentucky,17,31,17,14,.548,6225,917,1993,674,1315,243,678,427,628,410,834,1244,453,196,190,356,502,2504,.460,.513,.358,.680,.546,.521
180,2023-24,Evansville,17,35,17,18,.486,7050,915,2043,678,1338,237,705,414,577,270,908,1178,451,227,108,406,535,2481,.448,.507,.336,.718,.535,.506
181,2023-24,Florida State,17,33,17,16,.515,6625,903,1995,703,1365,200,630,520,735,336,762,1098,406,305,142,392,651,2526,.453,.515,.317,.707,.539,.503
182,2023-24,Furman,17,33,17,16,.515,6700,911,2054,591,1066,320,988,481,661,371,876,1247,535,235,95,391,528,2623,.444,.554,.324,.728,.554,.521
183,2023-24,Gardner-Webb,17,33,17,16,.515,6679,867,1992,618,1270,249,722,443,702,370,890,1260,419,193,78,385,633,2426,.435,.487,.345,.631,.522,.498
184,2023-24,Kent State,17,34,17,17,.500,6925,890,2016,608,1228,282,788,482,646,377,801,1178,436,234,89,403,609,2544,.441,.495,.358,.746,.548,.511
185,2023-24,Louisiana State,17,33,17,16,.515,6625,868,1907,612,1190,256,717,528,730,345,832,1177,388,264,125,434,574,2520,.455,.514,.357,.723,.559,.522
186,2023-24,Missouri State,17,33,17,16,.515,6700,848,1931,625,1220,223,711,432,608,335,956,1291,399,142,149,397,504,2351,.439,.512,.314,.711,.530,.497
187,2023-24,Montana State,17,35,17,18,.486,7100,941,2012,622,1149,319,863,434,596,237,831,1068,463,289,84,408,647,2635,.468,.541,.370,.728,.574,.547
188,2023-24,Portland State,17,32,17,15,.531,6447,809,1949,572,1219,237,730,447,652,375,806,1181,379,226,107,361,579,2302,.415,.469,.325,.686,.510,.476
189,2023-24,SIU Edwardsville,17,33,17,16,.515,6600,832,1965,593,1245,239,720,457,631,375,800,1175,374,226,137,352,550,2360,.423,.476,.332,.724,.521,.484
190,2023-24,Texas State,17,35,17,18,.486,7051,883,1988,724,1500,159,488,520,747,388,855,1243,413,258,118,470,617,2445,.444,.483,.326,.696,.522,.484
191,2023-24,Wagner,17,33,17,16,.515,6675,758,1913,520,1186,238,727,349,496,369,814,1183,421,195,76,326,507,2103,.396,.438,.327,.704,.489,.458
192,2023-24,Washington,17,32,17,15,.531,6525,931,1980,673,1252,258,728,459,636,301,850,1151,482,184,118,374,585,2579,.470,.538,.354,.722,.565,.535
193,2023-24,Winthrop,17,32,17,15,.531,6550,818,1763,580,1066,238,697,601,856,341,793,1134,380,201,89,415,570,2475,.464,.544,.341,.702,.570,.531
194,2023-24,Wofford,17,32,17,15,.531,6499,874,1905,568,1053,306,852,330,532,337,853,1190,494,142,86,373,522,2384,.459,.539,.359,.620,.552,.539
195,2023-24,Abilene Christian,16,34,16,18,.471,6875,861,1987,681,1457,180,530,550,757,329,810,1139,431,262,72,434,665,2452,.433,.467,.340,.727,.522,.479
196,2023-24,American,16,32,16,16,.500,6453,782,1740,503,946,279,794,355,492,287,756,1043,449,186,54,347,527,2200,.449,.532,.351,.722,.557,.530
197,2023-24,Arkansas,16,33,16,17,.485,6700,859,1898,660,1273,199,625,649,859,281,858,1139,387,198,201,395,655,2566,.453,.518,.318,.756,.556,.505
198,2023-24,Boston University,16,33,16,17,.485,6675,768,1856,514,1093,254,763,403,562,309,858,1167,427,216,102,384,571,2193,.414,.470,.333,.717,.516,.482
199,2023-24,California Baptist,16,33,16,17,.485,6650,762,1857,542,1183,220,674,478,700,397,844,1241,372,133,87,392,524,2222,.410,.458,.326,.683,.507,.470
200,2023-24,UC Riverside,16,34,16,18,.471,6832,842,2122,555,1218,287,904,433,604,420,836,1256,446,191,48,326,586,2404,.397,.456,.317,.717,.499,.464
201,2023-24,UC Santa Barbara,16,31,16,15,.516,6250,826,1684,639,1165,187,519,498,677,252,829,1081,417,152,99,405,511,2337,.490,.548,.360,.736,.583,.546
202,2023-24,Iona,16,33,16,17,.485,6600,857,1984,586,1216,271,768,369,566,345,706,1051,473,292,96,336,588,2354,.432,.482,.353,.652,.522,.500
203,2023-24,Jacksonville,16,33,16,17,.485,6625,835,1918,621,1268,214,650,485,688,412,797,1209,355,255,100,431,648,2371,.435,.490,.329,.705,.528,.491
204,2023-24,La Salle,16,33,16,17,.485,6700,877,2041,596,1230,281,811,363,502,336,806,1142,484,209,110,316,550,2398,.430,.485,.346,.723,.526,.499
205,2023-24,Maryland,16,33,16,17,.485,6675,766,1854,565,1158,201,696,545,757,380,799,1179,360,217,149,387,576,2278,.413,.488,.289,.720,.515,.467
206,2023-24,Mercer,16,33,16,17,.485,6600,880,1961,670,1353,210,608,378,565,368,764,1132,434,229,113,367,631,2348,.449,.495,.345,.669,.527,.502
207,2023-24,Kansas City,16,32,16,16,.500,6500,813,1903,544,1092,269,811,405,568,367,795,1162,411,191,120,385,624,2300,.427,.498,.332,.713,.529,.498
208,2023-24,New Hampshire,16,31,16,15,.516,6225,801,1934,526,1086,275,848,421,565,285,875,1160,365,226,64,372,472,2298,.414,.484,.324,.745,.522,.485
209,2023-24,Niagara,16,32,16,16,.500,6475,822,1749,623,1199,199,550,476,633,235,740,975,409,180,70,378,480,2319,.470,.520,.362,.752,.566,.527
210,2023-24,North Florida,16,32,16,16,.500,6475,849,1917,466,854,383,1063,415,542,284,792,1076,398,179,116,362,517,2496,.443,.546,.360,.766,.574,.543
211,2023-24,Penn State,16,33,16,17,.485,6650,854,1951,599,1187,255,764,515,689,316,749,1065,417,275,112,366,603,2478,.438,.505,.334,.747,.544,.503
212,2023-24,Radford,16,33,16,17,.485,6675,871,1907,633,1252,238,655,397,537,339,804,1143,366,183,116,357,561,2377,.457,.506,.363,.739,.550,.519
213,2023-24,Sacred Heart,16,32,16,16,.500,6400,864,1898,627,1248,237,650,407,586,300,779,1079,440,279,161,373,540,2372,.455,.502,.365,.695,.545,.518
214,2023-24,South Alabama,16,32,16,16,.500,6500,835,1886,596,1194,239,692,458,611,254,803,1057,341,216,88,362,532,2367,.443,.499,.345,.750,.544,.506
215,2023-24,Southern Mississippi,16,32,16,16,.500,6400,775,1826,574,1212,201,614,485,693,343,834,1177,376,229,154,411,550,2236,.424,.474,.327,.700,.519,.479
216,2023-24,Temple,16,36,16,20,.444,7350,876,2214,580,1283,296,931,503,709,406,898,1304,402,265,105,357,610,2551,.396,.452,.318,.709,.500,.463
217,2023-24,Texas Southern,16,33,16,17,.485,6625,821,1980,579,1214,242,766,432,597,365,800,1165,384,228,124,415,610,2316,.415,.477,.316,.724,.512,.476
218,2023-24,Tulsa,16,31,16,15,.516,6275,779,1775,540,1044,239,731,528,717,270,821,1091,392,243,105,403,543,2325,.439,.517,.327,.736,.549,.506
219,2023-24,UCLA,16,33,16,17,.485,6600,762,1820,579,1268,183,552,470,644,339,776,1115,368,192,109,358,609,2177,.419,.457,.332,.730,.512,.469
220,2023-24,Utah Valley,16,32,16,16,.500,6450,801,1851,647,1311,154,540,443,655,335,844,1179,477,222,143,395,578,2199,.433,.494,.285,.676,.509,.474
221,2023-24,Xavier,16,34,16,18,.471,6800,923,2116,691,1438,232,678,501,672,401,896,1297,551,236,115,396,572,2579,.436,.481,.342,.746,.530,.491
222,2023-24,Ball State,15,31,15,16,.484,6275,769,1726,537,1085,232,641,510,665,294,788,1082,385,170,96,374,469,2280,.446,.495,.362,.767,.558,.513
223,2023-24,Binghamton,15,30,15,15,.500,6050,801,1738,637,1202,164,536,397,595,313,843,1156,435,150,113,366,498,2163,.461,.530,.306,.667,.535,.508
224,2023-24,Davidson,15,32,15,17,.469,6500,783,1816,548,1067,235,749,441,602,295,814,1109,403,207,112,338,511,2242,.431,.514,.314,.733,.533,.496
225,2023-24,Delaware State,15,34,15,19,.441,6925,851,1961,693,1467,158,494,541,766,385,785,1170,413,285,66,503,574,2401,.434,.472,.320,.706,.516,.474
226,2023-24,East Carolina,15,33,15,18,.455,6650,803,1903,585,1207,218,696,463,669,393,761,1154,406,260,92,358,516,2287,.422,.485,.313,.692,.515,.479
227,2023-24,FDU,15,32,15,17,.469,6450,843,2012,575,1200,268,812,476,680,364,827,1191,484,263,81,408,571,2430,.419,.479,.330,.700,.520,.486
228,2023-24,George Washington,15,32,15,17,.469,6575,841,1901,554,1105,287,796,488,654,293,887,1180,395,189,153,397,465,2457,.442,.501,.361,.746,.555,.518
229,2023-24,Illinois State,15,32,15,17,.469,6400,743,1752,549,1087,194,665,448,630,323,791,1114,400,178,72,360,502,2128,.424,.505,.292,.711,.519,.479
230,2023-24,Jackson State,15,32,15,17,.469,6425,799,1923,588,1273,211,650,470,668,417,744,1161,384,239,111,428,544,2279,.415,.462,.325,.704,.509,.470
231,2023-24,Kennesaw State,15,31,15,16,.484,6250,908,2035,616,1147,292,888,460,682,380,824,1204,460,228,126,374,623,2568,.446,.537,.329,.674,.544,.518
232,2023-24,Le Moyne,15,32,15,17,.469,6425,823,1906,508,996,315,910,357,469,270,823,1093,503,256,103,367,489,2318,.432,.510,.346,.761,.544,.514
233,2023-24,Maine,15,32,15,17,.469,6450,801,1831,628,1244,173,587,389,541,255,789,1044,397,269,105,365,522,2164,.437,.505,.295,.719,.518,.485
234,2023-24,Miami (FL),15,32,15,17,.469,6425,889,1960,603,1168,286,792,360,483,324,850,1174,454,229,100,386,419,2424,.454,.516,.361,.745,.554,.527
235,2023-24,Miami (OH),15,32,15,17,.469,6424,798,1802,539,1085,259,717,404,572,257,806,1063,462,202,99,375,552,2259,.443,.497,.361,.706,.545,.515
236,2023-24,Omaha,15,33,15,18,.455,6650,845,1873,639,1242,206,631,545,734,282,829,1111,336,200,73,326,552,2441,.451,.514,.326,.743,.549,.506
237,2023-24,North Alabama,15,32,15,17,.469,6528,857,1931,611,1252,246,679,487,634,317,815,1132,359,171,101,324,589,2447,.444,.488,.362,.768,.548,.508
238,2023-24,North Dakota State,15,32,15,17,.469,6575,873,1834,621,1167,252,667,390,543,271,826,1097,370,139,43,355,468,2388,.476,.532,.378,.718,.571,.545
239,2023-24,Rider,15,32,15,17,.469,6475,836,1921,654,1381,182,540,455,608,362,840,1202,427,210,124,398,560,2309,.435,.474,.337,.748,.522,.483
240,2023-24,Rutgers,15,32,15,17,.469,6425,750,1927,575,1317,175,610,417,634,392,796,1188,377,247,167,365,541,2092,.389,.437,.287,.658,.469,.435
241,2023-24,Southeastern Louisiana,15,32,15,17,.469,6451,764,1769,529,1092,235,677,446,613,343,777,1120,463,222,73,442,523,2209,.432,.484,.347,.728,.536,.498
242,2023-24,Southern California,15,33,15,18,.455,6700,872,1932,620,1223,252,709,450,649,331,792,1123,515,247,172,418,560,2446,.451,.507,.355,.693,.546,.517
243,2023-24,Wichita State,15,34,15,19,.441,6850,935,2091,715,1431,220,660,385,552,396,943,1339,413,213,142,419,522,2475,.447,.500,.333,.697,.526,.500
244,2023-24,Wyoming,15,32,15,17,.469,6450,791,1755,550,1107,241,648,508,686,307,796,1103,374,165,80,408,500,2331,.451,.497,.372,.741,.560,.519
245,2023-24,Alcorn State,14,32,14,18,.438,6425,818,1851,652,1359,166,492,498,699,360,726,1086,371,220,56,370,567,2300,.442,.480,.337,.712,.527,.487
246,2023-24,Arizona State,14,32,14,18,.438,6425,791,1901,576,1185,215,716,412,629,269,795,1064,385,263,117,335,532,2209,.416,.486,.300,.655,.502,.473
247,2023-24,Bucknell,14,33,14,19,.424,6675,758,1770,489,975,269,795,368,514,276,797,1073,399,202,113,405,559,2153,.428,.502,.338,.716,.534,.504
248,2023-24,Cal State Fullerton,14,32,14,18,.438,6425,740,1717,533,1090,207,627,485,685,269,779,1048,284,214,98,393,571,2172,.431,.489,.330,.708,.532,.491
249,2023-24,Campbell,14,32,14,18,.438,6475,806,1740,574,1067,232,673,428,590,246,794,1040,425,202,77,383,485,2272,.463,.538,.345,.725,.562,.530
250,2023-24,Canisius,14,32,14,18,.438,6450,841,1910,609,1220,232,690,338,541,384,797,1181,401,192,111,432,520,2252,.440,.499,.336,.625,.520,.501
251,2023-24,Eastern Illinois,14,32,14,18,.438,6400,822,1951,643,1391,179,560,381,521,349,782,1131,413,258,95,331,567,2204,.421,.462,.320,.731,.501,.467
252,2023-24,Florida Gulf Coast,14,32,14,18,.438,6425,827,1817,577,1113,250,704,349,502,316,782,1098,375,193,108,363,464,2253,.455,.518,.355,.695,.548,.524
253,2023-24,Georgia State,14,31,14,17,.452,6250,856,1967,622,1249,234,718,424,560,325,835,1160,366,179,89,301,543,2370,.435,.498,.326,.757,.531,.495
254,2023-24,Georgia Tech,14,32,14,18,.438,6500,810,1924,556,1144,254,780,398,561,367,852,1219,425,140,128,393,527,2272,.421,.486,.326,.709,.519,.487
255,2023-24,Harvard,14,27,14,13,.519,5450,665,1516,465,920,200,596,370,527,250,691,941,351,168,117,328,400,1900,.439,.505,.336,.702,.538,.505
256,2023-24,Idaho State,14,34,14,20,.412,6925,875,1902,657,1239,218,663,429,625,337,756,1093,408,238,121,372,546,2397,.460,.530,.329,.686,.545,.517
257,2023-24,Jacksonville State,14,32,14,18,.438,6425,803,1778,633,1271,170,507,464,661,370,808,1178,354,216,126,433,524,2240,.452,.498,.335,.702,.535,.499
258,2023-24,Lehigh,14,32,14,18,.438,6550,829,1887,599,1173,230,714,438,596,263,874,1137,422,231,73,386,532,2326,.439,.511,.322,.735,.536,.500
259,2023-24,Middle Tennessee,14,33,14,19,.424,6725,741,1843,500,1069,241,774,444,631,344,803,1147,329,175,138,462,516,2167,.402,.468,.311,.704,.506,.467
260,2023-24,Northern Arizona,14,33,14,19,.424,6650,825,1883,618,1220,207,663,408,586,274,760,1034,444,187,102,416,605,2265,.438,.507,.312,.696,.524,.493
261,2023-24,Presbyterian,14,33,14,19,.424,6650,897,1901,687,1272,210,629,465,701,312,787,1099,426,232,106,377,612,2469,.472,.540,.334,.663,.553,.527
262,2023-24,Queens (NC),14,33,14,19,.424,6600,928,2095,634,1231,294,864,493,694,372,848,1220,435,230,91,377,573,2643,.443,.515,.340,.710,.545,.513
263,2023-24,South Carolina State,14,32,14,18,.438,6450,784,1914,584,1294,200,620,477,692,477,726,1203,435,267,111,487,666,2245,.410,.451,.323,.689,.501,.462
264,2023-24,Stanford,14,32,14,18,.438,6500,882,1886,596,1112,286,774,393,540,248,849,1097,515,176,99,410,490,2443,.468,.536,.370,.728,.570,.543
265,2023-24,Tulane,14,31,14,17,.452,6300,856,1798,623,1145,233,653,595,813,217,813,1030,440,243,136,347,530,2540,.476,.544,.357,.732,.581,.541
266,2023-24,Alabama State,13,32,13,19,.406,6514,772,2087,549,1294,223,793,428,592,453,812,1265,345,277,123,361,609,2195,.370,.424,.281,.723,.463,.423
267,2023-24,Albany (NY),13,32,13,19,.406,6425,918,2059,668,1302,250,757,431,594,364,789,1153,411,266,101,425,621,2517,.446,.513,.330,.726,.538,.507
268,2023-24,Arkansas–Pine Bluff,13,31,13,18,.419,6200,813,1821,476,923,337,898,520,682,261,812,1073,467,183,67,413,568,2483,.446,.516,.375,.762,.579,.539
269,2023-24,Brown,13,31,13,18,.419,6307,782,1818,528,1073,254,745,394,603,367,787,1154,417,196,131,385,519,2212,.430,.492,.341,.653,.526,.500
270,2023-24,Cal State Bakersfield,13,32,13,19,.406,6475,807,1861,657,1385,150,476,435,602,382,727,1109,335,220,114,389,652,2199,.434,.474,.315,.723,.512,.474
271,2023-24,California,13,32,13,19,.406,6550,833,1980,552,1149,281,831,420,578,343,846,1189,387,193,83,370,552,2367,.421,.480,.338,.727,.525,.492
272,2023-24,Chicago State,13,32,13,19,.406,6425,771,1816,570,1175,201,641,481,676,389,685,1074,354,277,103,422,559,2224,.425,.485,.314,.712,.520,.480
273,2023-24,Columbia,13,27,13,14,.481,5400,749,1597,518,981,231,616,349,477,265,699,964,471,209,62,330,437,2078,.469,.528,.375,.732,.570,.541
274,2023-24,Eastern Michigan,13,31,13,18,.419,6275,783,1825,605,1240,178,585,303,454,321,748,1069,321,179,77,361,508,2047,.429,.488,.304,.667,.502,.478
275,2023-24,Elon,13,32,13,19,.406,6400,824,1848,549,1067,275,781,416,588,331,751,1082,418,201,85,379,503,2339,.446,.515,.352,.707,.550,.520
276,2023-24,Fordham,13,33,13,20,.394,6725,798,1993,533,1152,265,841,464,701,430,795,1225,419,265,156,426,666,2325,.400,.463,.315,.662,.500,.467
277,2023-24,Marshall,13,33,13,20,.394,6600,864,2117,594,1247,270,870,437,615,406,897,1303,492,230,144,393,530,2435,.408,.476,.310,.711,.505,.472
278,2023-24,Mount St. Mary's,13,32,13,19,.406,6475,876,1852,659,1237,217,615,358,494,312,813,1125,423,221,125,465,496,2327,.473,.533,.353,.725,.558,.532
279,2023-24,Navy,13,31,13,18,.419,6250,716,1809,535,1206,181,603,447,631,386,718,1104,376,207,63,317,559,2060,.396,.444,.300,.708,.488,.446
280,2023-24,New Mexico State,13,32,13,19,.406,6475,771,1822,565,1196,206,626,418,617,286,793,1079,359,195,98,382,636,2166,.423,.472,.329,.677,.512,.480
281,2023-24,Notre Dame,13,33,13,20,.394,6675,742,1824,491,1034,251,790,378,508,324,861,1185,335,189,80,413,497,2113,.407,.475,.318,.744,.512,.476
282,2023-24,Oregon State,13,32,13,19,.406,6550,772,1745,576,1148,196,597,464,630,275,766,1041,355,192,119,395,593,2204,.442,.502,.328,.737,.539,.499
283,2023-24,Pepperdine,13,33,13,20,.394,6600,868,1924,643,1300,225,624,442,628,334,781,1115,438,169,90,370,537,2403,.451,.495,.361,.704,.541,.510
284,2023-24,Saint Louis,13,33,13,20,.394,6600,845,1873,586,1168,259,705,524,699,287,820,1107,426,200,101,388,596,2473,.451,.502,.367,.750,.561,.520
285,2023-24,Texas A&M–Commerce,13,33,13,20,.394,6825,829,1996,541,1074,288,922,415,592,316,759,1075,457,262,164,385,582,2361,.415,.504,.312,.701,.518,.487
286,2023-24,Alabama A&M,12,35,12,23,.343,7025,806,1918,658,1402,148,516,654,906,394,854,1248,369,261,136,565,727,2414,.420,.469,.287,.722,.514,.459
287,2023-24,Fresno State,12,33,12,21,.364,6700,812,1794,583,1104,229,690,380,555,260,783,1043,411,203,81,415,520,2233,.453,.528,.332,.685,.543,.516
288,2023-24,Illinois–Chicago,12,33,12,21,.364,6725,844,1927,557,1137,287,790,344,500,271,839,1110,459,203,176,408,583,2319,.438,.490,.363,.688,.536,.512
289,2023-24,Loyola Marymount,12,31,12,19,.387,6200,802,1791,541,1081,261,710,379,519,307,775,1082,369,114,81,333,504,2244,.448,.500,.368,.730,.551,.521
290,2023-24,Murray State,12,32,12,20,.375,6425,821,1841,612,1190,209,651,381,547,299,749,1048,369,192,88,304,490,2232,.446,.514,.321,.697,.531,.503
291,2023-24,Northeastern,12,32,12,20,.375,6400,810,1780,606,1138,204,642,397,531,326,736,1062,435,200,107,398,485,2221,.455,.533,.318,.748,.546,.512
292,2023-24,Oklahoma State,12,32,12,20,.375,6475,793,1799,533,1021,260,778,426,611,294,784,1078,428,200,92,413,511,2272,.441,.522,.334,.697,.544,.513
293,2023-24,Oral Roberts,12,31,12,19,.387,6250,812,1846,527,1056,285,790,366,493,235,787,1022,341,175,106,300,534,2275,.440,.499,.361,.742,.547,.517
294,2023-24,Portland,12,33,12,21,.364,6625,826,1891,534,1049,292,842,416,581,276,836,1112,446,136,72,394,490,2360,.437,.509,.347,.716,.545,.514
295,2023-24,Rhode Island,12,32,12,20,.375,6400,826,1800,617,1201,209,599,461,713,332,846,1178,408,151,99,403,541,2322,.459,.514,.349,.647,.543,.517
296,2023-24,South Dakota,12,32,12,20,.375,6500,875,1916,624,1247,251,669,433,583,334,864,1198,391,115,56,411,511,2434,.457,.500,.375,.743,.555,.522
297,2023-24,Western Michigan,12,32,12,20,.375,6475,828,1912,575,1165,253,747,372,595,402,810,1212,418,169,87,428,550,2281,.433,.494,.339,.625,.520,.499
298,2023-24,The Citadel,11,32,11,21,.344,6425,819,1782,622,1182,197,600,425,602,300,794,1094,359,179,84,385,447,2260,.460,.526,.328,.706,.546,.515
299,2023-24,Utah Tech,11,31,11,20,.355,6250,771,1724,570,1128,201,596,451,699,307,763,1070,401,205,133,495,647,2194,.447,.505,.337,.645,.534,.506
300,2023-24,Florida International,11,33,11,22,.333,6625,882,2019,598,1179,284,840,381,569,344,700,1044,465,337,135,451,595,2429,.437,.507,.338,.670,.531,.507
301,2023-24,Idaho,11,32,11,21,.344,6425,785,1778,542,1052,243,726,357,487,254,756,1010,392,179,102,367,567,2170,.442,.515,.335,.733,.540,.510
302,2023-24,Lafayette,11,32,11,21,.344,6500,744,1823,517,1095,227,728,295,438,279,785,1064,421,210,139,372,518,2010,.408,.472,.312,.674,.495,.470
303,2023-24,Louisiana–Monroe,11,30,11,19,.367,6025,751,1788,599,1275,152,513,442,665,396,737,1133,381,219,66,374,539,2096,.420,.470,.296,.665,.498,.463
304,2023-24,UMBC,11,32,11,21,.344,6425,955,2049,700,1335,255,714,352,504,304,875,1179,417,163,126,418,505,2517,.466,.524,.357,.698,.550,.528
305,2023-24,Morgan State,11,31,11,20,.355,6250,840,1862,692,1357,148,505,425,561,338,761,1099,388,192,111,451,594,2253,.451,.510,.293,.758,.529,.491
306,2023-24,Northern Illinois,11,31,11,20,.355,6275,800,1802,573,1106,227,696,442,658,320,791,1111,317,164,153,394,539,2269,.444,.518,.326,.672,.537,.507
307,2023-24,Pennsylvania,11,29,11,18,.379,5901,781,1721,506,971,275,750,322,468,303,739,1042,428,173,67,323,431,2159,.454,.521,.367,.688,.555,.534
308,2023-24,Rice,11,32,11,21,.344,6475,833,1880,582,1136,251,744,387,557,330,804,1134,461,178,117,372,463,2304,.443,.512,.337,.695,.537,.510
309,2023-24,UTSA,11,32,11,21,.344,6500,837,2040,526,1118,311,922,498,701,419,870,1289,444,161,133,360,573,2483,.410,.470,.337,.710,.523,.487
310,2023-24,Army,10,32,10,22,.313,6475,707,1747,455,959,252,788,264,449,308,780,1088,401,184,126,389,506,1930,.405,.474,.320,.588,.492,.477
311,2023-24,Charleston Southern,10,30,10,20,.333,6000,715,1727,507,1098,208,629,390,530,301,765,1066,306,115,90,366,512,2028,.414,.462,.331,.736,.512,.474
312,2023-24,Holy Cross,10,33,10,23,.303,6625,815,1857,566,1153,249,704,315,476,273,806,1079,365,133,109,364,532,2194,.439,.491,.354,.662,.527,.506
313,2023-24,New Orleans,10,33,10,23,.303,6629,846,2023,667,1434,179,589,556,772,377,762,1139,391,254,118,407,629,2427,.418,.465,.304,.720,.508,.462
314,2023-24,Prairie View A&M,10,31,10,21,.323,6200,770,1831,621,1342,149,489,487,675,303,649,952,373,283,87,396,626,2176,.421,.463,.305,.721,.506,.461
315,2023-24,Robert Morris,10,32,10,22,.313,6498,833,1927,560,1115,273,812,387,540,391,768,1159,431,157,92,443,564,2326,.432,.502,.336,.717,.533,.503
316,2023-24,Sacramento State,10,34,10,24,.294,6800,798,1855,540,1075,258,780,428,598,399,810,1209,444,178,93,495,577,2282,.430,.502,.331,.716,.533,.500
317,2023-24,USC Upstate,10,30,10,20,.333,6075,780,1753,550,1062,230,691,340,530,262,688,950,375,217,96,346,589,2130,.445,.518,.333,.642,.531,.511
318,2023-24,Southern Utah,10,31,10,21,.323,6225,820,1861,625,1212,195,649,491,674,322,727,1049,375,202,92,373,548,2326,.441,.516,.300,.728,.533,.493
319,2023-24,Tennessee Tech,10,31,10,21,.323,6250,758,1692,556,1084,202,608,371,522,191,766,957,379,156,90,369,421,2089,.448,.513,.332,.711,.538,.508
320,2023-24,William & Mary,10,33,10,23,.303,6625,787,1910,491,994,296,916,435,620,341,820,1161,407,156,56,357,560,2305,.412,.494,.323,.702,.523,.490
321,2023-24,Air Force,9,31,9,22,.290,6250,727,1604,454,847,273,757,324,475,225,647,872,451,202,122,372,541,2051,.453,.536,.361,.682,.560,.538
322,2023-24,Central Arkansas,9,32,9,23,.281,6425,817,1965,561,1218,256,747,419,566,359,806,1165,437,225,105,407,548,2309,.416,.461,.343,.740,.517,.481
323,2023-24,Coastal Carolina,9,31,9,22,.290,6250,835,1880,634,1254,201,626,409,616,353,897,1250,395,178,97,420,496,2280,.444,.506,.321,.664,.525,.498
324,2023-24,Georgetown,9,32,9,23,.281,6450,775,1867,510,1101,265,766,452,633,390,700,1090,391,183,98,390,533,2267,.415,.463,.346,.714,.523,.486
325,2023-24,Georgia Southern,9,33,9,24,.273,6675,847,1971,538,1093,309,878,417,570,347,783,1130,354,228,132,436,662,2420,.430,.492,.352,.732,.540,.508
326,2023-24,Hampton,9,33,9,24,.273,6600,853,2011,612,1252,241,759,422,591,372,849,1221,421,193,123,411,537,2369,.424,.489,.318,.714,.517,.484
327,2023-24,Lindenwood,9,31,9,22,.290,6225,696,1726,547,1199,149,527,478,653,272,711,983,249,191,77,373,541,2019,.403,.456,.283,.732,.496,.446
328,2023-24,Maryland Eastern Shore,9,29,9,20,.310,5875,668,1664,500,1094,168,570,386,540,315,699,1014,312,203,81,399,508,1890,.401,.457,.295,.715,.492,.452
329,2023-24,Northwestern State,9,32,9,23,.281,6500,808,1872,604,1229,204,643,437,663,365,742,1107,368,223,105,425,598,2257,.432,.491,.317,.659,.516,.486
330,2023-24,San Jose State,9,32,9,23,.281,6450,832,1856,565,1078,267,778,297,423,252,734,986,433,165,106,336,547,2228,.448,.524,.343,.702,.542,.520
331,2023-24,Southeast Missouri State,9,31,9,22,.290,6225,764,1848,572,1217,192,631,358,512,279,705,984,383,178,78,371,606,2078,.413,.470,.304,.699,.497,.465
332,2023-24,Vanderbilt,9,32,9,23,.281,6425,748,1877,539,1139,209,738,468,660,344,758,1102,300,196,92,333,489,2173,.399,.473,.283,.709,.496,.454
333,2023-24,West Virginia,9,32,9,23,.281,6450,767,1784,534,1117,233,667,467,662,293,787,1080,417,139,114,405,487,2234,.430,.478,.349,.705,.532,.495
334,2023-24,Bellarmine,8,31,8,23,.258,6250,797,1837,559,1139,238,698,321,412,245,757,1002,420,164,60,297,486,2153,.434,.491,.341,.779,.530,.499
335,2023-24,Incarnate Word,8,31,8,23,.258,6250,768,1795,532,1083,236,712,468,644,333,800,1133,377,187,128,495,589,2240,.428,.491,.331,.727,.533,.494
336,2023-24,Louisville,8,32,8,24,.250,6425,799,1833,624,1262,175,571,531,712,318,782,1100,356,174,83,410,544,2304,.436,.494,.306,.746,.531,.484
337,2023-24,Michigan,8,32,8,24,.250,6475,829,1869,574,1159,255,710,421,599,340,794,1134,400,133,114,414,549,2334,.444,.495,.359,.703,.542,.512
338,2023-24,Missouri,8,32,8,24,.250,6425,807,1838,574,1108,233,730,462,583,293,699,992,390,245,154,370,642,2309,.439,.518,.319,.792,.546,.502
339,2023-24,Saint Francis (PA),8,30,8,22,.267,6025,713,1682,520,1106,193,576,336,551,357,681,1038,367,178,107,412,532,1955,.424,.470,.335,.610,.503,.481
340,2023-24,Southern Indiana,8,32,8,24,.250,6425,737,1811,522,1147,215,664,506,679,319,820,1139,362,204,94,423,672,2195,.407,.455,.324,.745,.514,.466
341,2023-24,LIU,7,29,7,22,.241,5850,706,1691,549,1185,157,506,360,532,272,742,1014,363,187,88,422,557,1929,.418,.463,.310,.677,.496,.464
342,2023-24,Loyola (MD),7,32,7,25,.219,6475,737,1767,507,1082,230,685,345,536,328,769,1097,410,189,69,436,518,2049,.417,.469,.336,.644,.507,.482
343,2023-24,Manhattan,7,30,7,23,.233,6075,740,1792,521,1097,219,695,286,396,275,714,989,432,226,88,402,417,1985,.413,.475,.315,.722,.501,.474
344,2023-24,NJIT,7,28,7,21,.250,5600,663,1681,462,1015,201,666,375,529,321,651,972,294,201,92,311,535,1902,.394,.455,.302,.709,.492,.454
345,2023-24,North Carolina A&T,7,32,7,25,.219,6400,726,1873,534,1204,192,669,454,637,300,720,1020,326,180,104,300,488,2098,.388,.444,.287,.713,.482,.439
346,2023-24,Old Dominion,7,32,7,25,.219,6450,841,2001,620,1307,221,694,365,551,320,814,1134,330,251,123,349,581,2268,.420,.474,.318,.662,.501,.476
347,2023-24,Valparaiso,7,32,7,25,.219,6400,796,1961,562,1240,234,721,337,471,320,744,1064,384,197,113,353,521,2163,.406,.453,.325,.715,.495,.466
348,2023-24,Dartmouth,6,27,6,21,.222,5400,594,1447,403,821,191,626,291,422,200,698,898,332,120,95,344,374,1670,.411,.491,.305,.690,.507,.477
349,2023-24,Florida A&M,6,29,6,23,.207,5900,727,1679,557,1184,170,495,325,464,278,724,1002,414,173,82,442,541,1949,.433,.470,.343,.700,.513,.484
350,2023-24,Houston Christian,6,29,6,23,.207,5825,759,1751,612,1263,147,488,409,635,346,730,1076,330,162,82,445,422,2074,.433,.485,.301,.644,.505,.475
351,2023-24,IUPUI,6,32,6,26,.188,6425,775,1768,665,1324,110,444,448,609,316,628,944,332,244,67,468,558,2108,.438,.502,.248,.736,.512,.469
352,2023-24,Pacific,6,32,6,26,.188,6450,725,1762,522,1119,203,643,418,650,209,666,875,422,195,64,377,551,2071,.411,.466,.316,.643,.500,.469
353,2023-24,Texas–Rio Grande Valley,6,31,6,25,.194,6250,754,1801,594,1254,160,547,513,728,290,747,1037,400,251,92,434,563,2181,.419,.474,.293,.705,.508,.463
354,2023-24,Buffalo,4,31,4,27,.129,6225,770,1830,563,1084,207,746,361,504,323,759,1082,415,188,141,450,484,2108,.421,.519,.277,.716,.509,.477
355,2023-24,Cal Poly,4,32,4,28,.125,6475,719,1778,521,1180,198,598,401,569,283,717,1000,314,173,117,405,614,2037,.404,.442,.331,.705,.497,.460
356,2023-24,Siena,4,32,4,28,.125,6400,702,1758,533,1155,169,603,361,541,375,757,1132,342,164,130,505,491,1934,.399,.461,.280,.667,.480,.447
357,2023-24,Stonehill,4,31,4,27,.129,6225,714,1788,461,954,253,834,286,415,257,763,1020,366,198,77,421,477,1967,.399,.483,.303,.689,.495,.470
358,2023-24,VMI,4,32,4,28,.125,6425,818,1935,608,1262,210,673,358,517,299,871,1170,335,179,82,507,539,2204,.423,.482,.312,.692,.505,.477
359,2023-24,DePaul,3,32,3,29,.094,6400,725,1714,525,1117,200,597,421,574,233,718,951,392,168,99,435,482,2071,.423,.470,.335,.733,.521,.481
360,2023-24,Coppin State,2,29,2,27,.069,5850,585,1571,432,1031,153,540,355,489,283,590,873,240,222,81,455,513,1678,.372,.419,.283,.726,.465,.421
361,2023-24,Detroit Mercy,1,32,1,31,.031,6450,761,1806,574,1140,187,666,402,547,286,659,945,346,222,78,427,553,2111,.421,.504,.281,.735,.511,.473
362,2023-24,Mississippi Valley State,1,31,1,30,.032,6225,613,1611,470,1122,143,489,350,532,298,613,911,271,205,71,495,550,1719,.381,.419,.292,.658,.461,.425